Name	FinalUnit
AADO2	mmHg
ABP	mmHg
Acetaminophen	ug/mL
Albmin_over_Creatinine	mg/mmol
Albumin	g/dL
AlbuminELCP%	%
ALKP	IU/L
ALP	IU/L
Alpha_Fetoprotein	ng/mL
Alpha1Globulin	%
Alpha2Globulin	%
ALT	U/L
Ammonia	umol/L
Amylase	U/L
Apgar10Min	score
Apgar1Min	score
Apgar5Min	score
Apnea_Time_Interval	sec
aPTT	sec
Art_PaCO2	mmHg
Art_PaO2	mmHg
Arterial_BP_Dia	mmHg
Arterial_BP_Mean	mmHg
Arterial_BP_Sys	mmHg
Ascites_Albumin	g/dL
Ascites_Amylase	U/L
Ascites_Glucose	mg/dL
Ascites_Lactate	IU/L
Ascites_Lymphocytes%	%
Ascites_Macrophage%	%
Ascites_Monocytes%	%
Ascites_Polys%	%
Ascites_Protein_Total	g/dL
Ascites_RBC	#/uL
Ascites_WBC	#/uL
AST	IU/L
Atypical_Lymphocytes	%
B12	pg/mL
Bands#	10^9/L
Bands%	%
Base_excess	mEq/L
Basophils#	10*9/L
Basophils%	%
BetaGlobulin	%
Bicarbonate	mmol/L
Bilirubin	mg/dL
Bilirubin_Direct	MG/DL
Bilirubin_Indirect	mg/dL
BLASTS	score
Blasts%	%
Blood-UR	ERY/uL
BMI	kg/m2
BNP	PG/ML
BP	mmHg
BP_Dia_newborn	mmHg
BP_Mean_newborn	mmHg
BP_Sys_newborn	mmHg
BUN	mg/dL
C3	g/L
C4	g/L
Ca	mg/dL
CA125	kU/L
CA153	kU/L
CA199	kU/L
CA72-4	kU/L
Carboxyhemoglobin	%
CD3	#/uL
CD3%	%
CD4	#/uL
CD4%	%
CD4_Over_CD8	ratio
CD8	#/uL
CD8%	%
CEA	mmol/L
CHADS2	score
CHADS2_VASC	score
Cholesterol	mg/dL
Cholesterol_over_HDL	ratio
CK	IU/L
CK_MB_INDEX	%
Cl	mmol/L
CO2	mmol/L
CorrectedCa	mg/dL
Cortisol	ug/dL
CPOT	score
Creatine_Kinase	IU/L
Creatine_Kinase_MB	ng/mL
Creatinine	mg/dL
Creatinine-UR_24h	MG/24H
CRP	mg/dL
CSF_Glucose	mg/dL
CSF_Lymphocytes%	%
CSF_Monocytes%	%
CSF_Polys%	%
CSF_Protein_Total	g/dL
CSF_RBC	#/uL
CSF_WBC	#/uL
CVP	mmHg
Cyclosporine	NG/ML
Cyclosporine_level	ng/ml
D_DIMER	NG/ML
Digoxin	nmol/L
eGFR	mL/min/1.73m*2
eGFR_CKD_EPI	mL/min
eGFR_MDRD	mL/min
Eosinophils#	10*9/L
Eosinophils%	%
Erythrocyte	mm/h
ESR	MM/HR
ETCO2	mmHg
Ethanol	mg/dL
ExpRatio	ratio
Ferritin	ug/L
Fev1	L
Fev1_over_Fvc	%
Fibrinogen	mg/dL
FingerStick_Glucose	mg/dL
FiO2	torr
Fluid_Balance	cc
Folate	ug/L
Follic_Acid	ug/L
freeCalcium	MMOL/L
FreeT3	pmol/L
FreeT4	pmol/L
FSH	IU/L
Fvc	L
GammaGlobulin	%
GCS_Total	score
Gentamicin	ug/mL
GFR	mL/min
GGT	IU/L
Globulin	g/L
Glucose	mg/dL
Granulocytes	#/uL
Haptoglobin	mg/dL
HbA1C	%
HbA1C#	MMOL/MOL
HCG	IU/L
HDL	mg/dL
HDL_over_Cholesterol	ratio
HDL_over_LDL	ratio
HDL_over_nonHDL	ratio
HDW	G/DL
Heart_Rate	bpm
Height	cm
Hematocrit	%
Hemoglobin	g/dL
Hyperchromia	%
Hypochromia	%
I_E_Ratio	ratio
IgA	MG/DL
IGFL	unit
IgG	MG/DL
IgM	MG/DL
Immature_Granulocytes#	10*9/L
Immature_Granulocytes%	%
ImmatureReticulocyteFraction	%
INR	ratio
InspRatio	ratio
InspTime	sec
Iron_Binding_Capacity	ug/dL
Iron_Fe	ug/dL
IV_FLUIDS	cc
K+	mmol/L
Lactate	MG/DL
LDH	U/L
LDL	mg/dL
LDL_over_HDL	ratio
Lipase	U/L
Lithium	mmol/L
LOBULARITY_INDEX-	score
LUC	10*9/L
LUC%	%
LuteinisingHormone	IU/L
Lymphocytes#	10*9/L
Lymphocytes%	%
Macrocytosis	%
Macrophage%	%
MCH	pg
MCHC	%
MCHC-M	g/dL
MCV	fL
Mean_Airway_Pressure	cmH2O
Mesothelial%	%
Metamyelocytes%	%
Methemoglobin_Over_Hemoglobin	%
Mg	mmol/L
Mg++	mmol\L
Microcytosis	%
Minute_Vol	L/min
Monocytes#	10*9/L
Monocytes%	%
MPV	fL
MPXI	score
Myelocytes%	%
Myelocytes%	%
Na	mmol/L
Neutrophils#	10*9/L
Neutrophils%	%
NonHDLCholesterol	mg/dL
NonInvasive_BP_Dia	mmHg
NonInvasive_BP_Mean	mmHg
NonInvasive_BP_Sys	mmHg
NRBC	10*9/L
NRBC%	%
NTproBNP	pg/mL
Nucleated_Erythrocytes%	%
O2_Flow	L/min
Osmolality	mOsm/kg
Osmolarity-BL	MOSMOL/KG
Osmolarity-UR	MOSMOL/KG
OtherFluids_Lymphocytes%	%
OtherFluids_Macrophage%	%
OtherFluids_Monocytes%	%
OtherFluids_Polys%	%
OtherFluids_RBC	#/uL
OtherFluids_RBC	#/uL
OtherFluids_WBC	#/uL
Oxygen_Over_InspiredGas	%
Pain_FLACC	score
PAP_Dia	mmHg
PAP_Mean	mmHg
PAP_Sys	mmHg
Parathyrin	pg/mL
PCO2	MMHG
PCT	%
PDW	fL
Peak_Insp_Pressure	cmH2O
PEEP_Set	cmH2O
PerZondaFluids	cc
PFR	L/min
pH	PH_UNITS
Phenobarbital	ug/mL
Phenytoin	ug/mL
Phosphate	mg/dL
Phosphore	mg/dL
PIP	cmH2O
PlasmaAnionGap	mmol/L
PlasmaViscosity	mPa.s
Plateau_Pressure	cmH2O
Plateletcrit	%
Platelets	10*9/L
Platelets_Hematocrit	%
PLEURAL_Albumin	g/dL
PLEURAL_Glucose	mg/dL
PLEURAL_Lactate	IU/L
PLEURAL_Lymphocytes%	%
PLEURAL_Macrophage%	%
PLEURAL_Monocytes%	%
PLEURAL_Polys%	%
PLEURAL_Protein_Total	g/dL
PLEURAL_RBC	#/uL
PLEURAL_WBC	#/uL
PO2	MMHG
Potassium	mEq/L
Progesterone	nmol/L
Prolactin	mU/L
Promyelocytes%	%
Protein_Total	g/dL
PSA	ug/L
PT	second
PTH	pg/mL
PTT	sec
PULSE	rate
RandomGlucose	mg/dL
RandomHDL	mmol/L
RandomLDL	mmol/L
RandomTriglyceride	mmol/L
RBC	10*12/L
RDW	
Resp_Rate	bpm
Resp_Rate_Set	bpm
Resp_Rate_Spont	bpm
Resp_Rate_Total	bpm
Reticulocytes#	X10^9/L
Reticulocytes%	%
Rheumatoid_Factor	IU/mL
Salicylate	mg/dL
SaO2	%
SaO2_OXIGEN	%
SaO2_ROOMAIR	%
SaO2_VENTILATED	%
Serum_Oestradiol	pmol/L
SerumAnionGap	mmol/L
Sex_Hormone_Binding_Globulin	nmol/L
Sirolimus	ng/mL
SO2	%
SVO2	%
T3	ng/dL
T4	nmol/L
Tacrolimus	ng/mL
Tacrolimus_FK	NG/ML
Temperature	degC
Teophylline	mg/L
Testosterone	nmol/L
TIBC	umol/L
Tidal_Volume_Obser	ml/B
Tidal_Volume_Set	ml/B
Tidal_Volume_Spont	ml/B
Tobramycin	ug/mL
Total_Fluids	cc/kg/day
Transferrin	mg/dL
Transferrin_Saturation_Index	%
Triglycerides	mg/dL
TroponinI	ug/L
TroponinT	ug/L
TSH	mU/L
Urea	mg/dL
Uric_Acid	mg/dL
Urine_Amylase	U/L
Urine_Bilirubin	MG/DL
Urine_Catheter	cc
Urine_Chloride	mEq/L
Urine_Creatinine	mmol/L
Urine_Epithelial_Cell	/uL
Urine_Epithelial_Cells	#/hpf
Urine_Glucose	MG/DL
Urine_Granular_Casts	#/lpf
Urine_Hyaline_Casts	#/lpf
Urine_Ketone	MG/DL
Urine_Microalbumin	mg/L
Urine_Osmolality	mOsm/kg
Urine_Per_Hour	cc
Urine_PH	unit
Urine_Phosphate	mg/dL
Urine_Potassium	MMOL/L
Urine_Protein_Creatinine	mg/mmol
Urine_Protein_Over_Creatinine	ratio
Urine_RBC	Ery/ÂµL
Urine_Sodium	mmol/L
Urine_Spec_Gravity	G/ML
Urine_Total_Protein	g/L
Urine_Transitional_Cells	#/hpf
Urine_UreaN	mg/dL
Urine_Urobilinogen	EU/DL
Urine_Vol	cc
Urine_WBC	1/uL
UrineAlbumin	mg/L
UrineAlbumin_over_Creatinine	mg/mmol
UrineTotalProtein	g/L
Valproate_Acid	ug/mL
Vancomycin	ug/mL
VAS	score
VAS_MOVEMENT	score
VENOUS_BP	mmHg
VitaminD_25	nmol/L
WBC	10*9/L
Weight	kg
