PC	PN
CCT	CRYPTOCOCCAL TITER CSF
HGG	HEMOGLOBIN, BLOOD GAS
FIT	STOOL OCC BLOOD, IA
UIM	URINE IMMUNOFIXATION
#AM	## ACROMEGALY W/U
#AD	## ADDISON'S DISEASE W/U
#AR	## ADRENAL MASS W/U
#AN	## AMENORRHEA ALGORITHM
#AE	## ANEMIA W/U
#BD	## BLEEDING DISORDERS W/U
#CC	## CALCULUS, UR W/U
#CR	## CREATININE ALGORITHM
#FS	## CRONIC FATIGUE DIAG
#CS	## CUSHING'S SYNDROME W/U
#DU	## DUODENAL ULCER W/U
#ED	## ERECTILE DYSFUNC W/U
#GR	## GALACTORRHEA ALGORITHM
#GU	## GASTRIC ULCER W/U
#GE	## GASTROESOPHAGEAL W/U
#GT	## GOITER W/U
#GM	## GYNECOMASTIA W/U
#HR	## HIRSUTISM W/U
#HC	## HYPERCALCEMIA W/U
#HK	## HYPERKALEMIA W/U
#HP	## HYPERPROLACTINEMIA W/U
#HT	## HYPERTHYRODISM W/U
#OK	## HYPKALEMIA W/U
#HG	## HYPOGLYCEMIA W/U
#ON	## HYPONATREMIA ALGORITHM
#OT	## HYPOTHYROIDISM W/U
#ID	## IDC PANEL, NEW HIV
#LC	## LIPID SCREENING W/U
#MH	## MALIG HYPERTHERM W/U
#ND	## NONULCER DYSPEPSIA W/U
#NI	## NSAID ULCER W/U
#OP	## OSTEOPOROSIS W/U
#PP	## PORPHYRIA W/U
#TD	## THROMBOTIC W/U
#TN	## THYROID NODULE W/U
$CP	$$ CRYOPRECIPITATE
$PF	$$ PLASMA FROZEN
$PL	$$ PLATELETS
$RP	$$ RED CELLS PACKED
$RL	$$ RED CELLS, LEUKODPTD
$RW	$$ RED CELLS, WASHED
$RD	$$ RED CELLS,DEGLYCD
&AU	&& AUTOPSY
&FS	&& FROZEN SECTION, TISSUE
&GE	&& GROSS EXAM,SURG SPEC
&HP	&& HISTOPATHOLOGY
&KB	&& KIDNEY BIOPSY
&LN	&& LYMPH NODE BIOPSY
&MB	&& MUSCLE BIOPSY
&NB	&& NERVE BIOPSY
R11	11-DEOXYCORTISOL
ROH	17 HYDROXYPROGESTERONE
RBU	17 KETOGENIC STEROIDS
RKT	17 KETOSTEROIDS
R17	17-HYDROXYCORTICOSTEROIDS
R7P	17-HYDROXYPREGNENOLONE
P17	17KETO,24HR UR,PEDS
R5F	5 FLUOROCYTOSINE
R5H	5-HYDROXYINDOLACETIC ACID
A2C	A1C VALIDATION
DSO	ABBREV.DRUG SCREEN (OB)
DSA	ABBREVIATED DRUG SCREEN
ARH	ABO, RH
ABP	ABPA PANEL
ANC	ABSOLUTE NEUTROPHIL COUNT
ACE	ACETAMINOPHEN
RAC	ACETYLCHOLINE RECEPTOR AB
ACH	ACETYLCHOLINESTERASE AF
HP2	ACID FAST ID
HPL	ACID FAST IDENTIFICATION
AFM	ACID FAST SUSCEPTIBILITY
APH	ACID PHOSPHATASE (PRO)
APR	ACT.PROTEIN C RESIST.
ACT	ACTH
ACS	ACTH STIMULATION TEST
ACY	ACYLCARNITINE
XCP	ADD CRYOPRESERVATION
ADD	ADD ON LAB TEST
XTF	ADD THAW FROZEN CELLS
ADA	ADDITIONAL CELLS
ADC	ADDITIONAL CELLS
ADS	ADDITIONAL CELLS
AID	ADDITIONAL IDENTIFICATION
ADK	ADDITIONAL KARYOTYPE
ASU	ADDITIONAL SUSCEPTIBILITY
ATC	ADDITIONAL TISSUE CULT
ADM	ADENOSINE DEAMINASE PL FL
MID	AFB BIOCHEMICAL ID
AFB	AFB CULTURE
AFR	AFB CULTURE BILL PANEL
MAF	AFB MASTER
MAV	AFB MAV DNA PROBE
TBR	AFB REFERRED RESULT
AFS	AFB SMEAR ONLY
CAF	AFP TUMOR MARKER CSF
AFP	AFP, TUMOR MARKER
P14	AIR ANA SUBS
ALB	ALBUMIN
BAL	ALBUMIN, BODY FLUID
ALC	ALCOHOL
RAD	ALDOLASE
RAS	ALDOSTERONE, SERUM
RAU	ALDOSTERONE, URINE
EML	ALK FISH NSCLC(LUNG)
ALK	ALKALINE PHOSPHATASE
ALI	ALKALINE PHOSPHATASE ISOE
AL2	ALLERGEN FOOD PANEL
RAR	ALLERGENS RAST
RDZ	ALLOPURINAL
ALD	ALMOND IGE ALLERGEN
A1A	ALPHA 1 ANTITRYPSIN,QUANT
RSU	ALPHA SUB UNIT
RE2	ALPHA1-ANTITRYPSIN MA
ALT	ALT (SGPT)
AAT	ALT FROM AML
ALR	ALUMINUM
ANP	AMI/NORTRIP MASTER PANEL
AMK	AMIKACIN
AUQ	AMINO ACID QUANT-URINE
AAU	AMINO ACID SCREEN, URINE
APQ	AMINO ACID, PLASMA, QUANT
AMI	AMITRIPTYLINE/NORTRIP
RAM	AMITRIPTYLINE/REFERRED
AAM	AMMONIA ARTERIAL
AMM	AMMONIA VENOUS
RDU	AMNIOTIC FLUID BILI
AFC	AMNIOTIC FLUID CMPLT ANAL
REI	AMOXAPINE
IAM	AMPHETAMINE CONF URINE
AMO	AMPHETAMINE CONFIRM (OB)
AMP	AMPHETAMINE SCREEN
GPA	AMPLIFIED GC/CT PROBE
GPU	AMPLIFIED GC/CT URINE
AMY	AMYLASE
UAM	AMYLASE URINE
RUM	AMYLASE URINE RANDOM
BAM	AMYLASE, BODY FLUID
AMF	AMYLASE, FRAC ISOENZYME
ANA	ANA SCREEN
ANM	ANA SCREEN MASTER
APT	ANA WORKUP
RAB	ANABOLIC STEROID SCREEN
P57	ANAEROBIC WORK UP
XA1	ANALYSIS FISH 10-30
XA3	ANALYSIS FISH 3-5
RAN	ANDROSTENEDIONE
APN	ANEMIA ABC PANEL
ANF	ANGELMAN FISH
RAG	ANGIO CONVERT ENZ SERUM
ACC	ANGIO CONVERT ENZYME CSF
XRA	ANTI RANA
ARA	ANTI RETICULIN AB IGA
DNA	ANTI-DNA ANTIBODY
RBV	ANTI-DNASE B
RAE	ANTI-ENA
REJ	ANTI-HISTONE ANTIBODIES
RJO	ANTI-JO-1 ANTIBODIES
AMA	ANTI-MITOCHONDRIAL AB
APC	ANTI-PARIETAL CELL AB
RPE	ANTI-PEMPHIGUS ANTIBODY
ASM	ANTI-SMOOTH MUSCLE AB
III	ANTI-THROMBIN III
RAA	ANTIADRENAL ANTIBODY
ABI	ANTIBODY IDENTIFICATION
ABS	ANTIBODY SCREEN
ABT	ANTIBODY TITER,RBC,PREN
AG	ANTIGEN TYPE
RNE	ANTINEUTROPHIL CYTOPLSMIC
AP	APT(SCR.FOR FETAL HGB)
PTT	APTT
RBO	ARBOVIRUS ANTIBODY MAC EI
ARC	ARC REFERENCE LAB WORKUP
RAV	ARGININE VASOPRESSIN(AVP)
ARR	ARSENIC URINE RANDOM
ARB	ARSENIC, BLOOD
ARS	ARSENIC-QUANT URINE
ART	ARTERIAL DRAW
MBG	ARTERIAL GASES
ASA	ARYLSULFATASE A
STT	ASO TITER
APA	ASPERGILLUS PANEL ALLERG
RAP	ASPERGILLUS SPECIFIC IGG
AST	AST (GOT)
ABC	AUTOMATED BLOOD COUNT
ADF	AUTOMATED DIFFERENTIAL
BEL	B CELL CLONALITY BY PCR
RPT	B PERTUSSIS AB IGA,IGG
BSB	B-STREP GROUP B AG
VB	B12 (ONLY B12 ORDERED)
B12	B12/FOLATE(ORDERS BOTH)
CB2	B2 MICROGLOBULIN, CSF
B2M	B2 MICROGLOBULIN, SERUM
BIG	BACTERIA ISOLATE GM STAIN
BII	BACTERIA ISOLATE ID
BIX	BACTERIA ISOLATE MASTER
BIS	BACTERIA ISOLATE SENS
IBA	BARBITUATES CONFIRM UR
BAR	BARBITURATE SCREEN
DSB	BASIC DRUGS OF ABUSE SCRN
BMT	BASIC METABOLIC PANEL
BCC	BC CONTAMINATION RATE
BFC	BDY FLD CHEM. MASTER
IBE	BENZODIAZEPINE CONFIRM
BEN	BENZODIAZEPINE SCREEN
BRY	BERYLLIUM, URINE
BHB	BETA HYDROXYBUTYRATE
B2T	BETA-2 TRANSFERRIN, BF
DIR	BETA-STREP GROUP B AG
RBA	BILE ACID (CHOLYGLYCINE)
BTB	BILIRUBIN, BODY FLUID
DBI	BILIRUBIN,DIRECT
TBI	BILIRUBIN,TOTAL
MCT	BILL MANUAL CELL COUNT
XMR	BILL MANUAL RETIC CT
ABO	BILL ONLY (ABO RH)
HS1	BILLING PANEL FOR HSV1
HS2	BILLING PANEL FOR HSV2
BIT	BIOTINIDASE
RBF	BIRD FANCIER DIS PANEL
BFH	BIRD FANCIERS H PROFILE
RDF	BISMUTH
BB	BLOOD BANK LBL - GENERIC
CLT	BLOOD BANK SPECIMEN
BCS	BLOOD CULT SENSITIVITY
BLC	BLOOD CULTURE
BCX	BLOOD CULTURE MASTER
DBG	BLOOD GAS-DIALYSATE
BG	BLOOD GASES ARTERIAL
CBG	BLOOD GASES CAPILLARY
VBG	BLOOD GASES VENOUS
UBL	BLOOD,URINE
BNP	BNP
BFL	BODY FLUID CULTURE
BFX	BODY FLUID CULTURE MASTER
BFG	BODY FLUID GRAM STAIN
BHT	BODY FLUID HCT
BFS	BODY FLUID SUSCEPTIBILITY
BMP	BONE MARROW PREP
RB2	BOTULISM
BZN	BRAZIL NUT IGE ALLERGEN
BRA	BRCA ASHKENAZI MULTISITE3
BRC	BRCA PROFILE
BR1	BRCA1
BR2	BRCA2
REO	BROMIDE
BWB	BRONCH WASH BILL ONLY
BWC	BRONCHWASH CULTURE
BWX	BRONCHWASH CULTURE MASTER
BWG	BRONCHWASH GRAM STAIN
BWS	BRONCHWASH SENSI
BUN	BUN
BPR	BUPROPION
BUT	BUTALBITAL
RCP	C - PEPTIDE
CRP	C-REACTIVE PROTEIN
CDM	C.DIFF PCR OHSU
CDI	C.DIFFICILE TOXIN, AG
C1E	C1 ESTERASE INHIBITOR QT
RAK	C1 ESTERASE INHIBRO FUNCT
RED	C1Q BINDING IMMUNE COMPLX
R1Q	C1Q COMPLEMENT COMPONENT
RC2	C2 COMPLEMENT COMPONENT
C34	C3 / C4 MASTER PANEL
C5	C5 COMPLEMENT COMPONENT
R19	CA 19-9
R15	CA 27.29
CA1	CA125
RCU	CADMIUM, URINE
CAD	CADMIUM,BLOOD
CLN	CALCITONIN
CA	CALCIUM
CF1	CALCIUM EXCRET. SERUM
FC1	CALCIUM EXCRET. SERUM
CFR	CALCIUM FRAC. EX. RANDOM
CFE	CALCIUM FRACT. EXCRETION
FCU	CALCIUM FRACT. EXCRETION
UCA	CALCIUM URINE
RCA	CALCIUM URINE RANDOM
BCA	CALCIUM, BODY FLUID
URC	CALCULUS ANALYSIS
CAS	CALPROTECTIN, STOOL
CAN	CANNABINOID SCREEN
ICN	CANNABINOIDS URINE CONFIR
DIA	CAPD CULTURE
DIX	CAPD CULTURE MASTR
DIS	CAPD SENSITIVITY
CAP	CAPILLARY COLLECTION
CAR	CARBAMAZEPINE
RCB	CARBAMAZEPINE/REFERRED
COH	CARBOXYHEMOGLOBIN
ANT	CARDIOLIPIN IGG & IGM
CTN	CARNITINE URINE
RDW	CARNITINE,FREE & TOTAL
RCC	CAROTENE
CHW	CASHEW IGE ALLERGEN
REZ	CAT SCRATCH FEVER AB
TIX	CAT TIP CULTURE MASTER
RCT	CATECHOLAMINES, PLASMA
RCM	CATECHOLAMINES, URINE
TIP	CATH TIP CULTURE
TIS	CATH TIP SUSCEPTIBILITY
CBC	CBC PANEL
CD4	CD4 (T CELL)
CDB	CD4 AND CD8
CEA	CEA
BCE	CEA, BODY FLUID
CEF	CEFOXITIN
CFT	CEFTRIAXONE
BCD	CELL COUNT, BODY FLUID
CCC	CELL COUNT, CSF
CER	CERULOPLASMIN
N25	CF NEG BIOCHEM
CFC	CF RESPIRATORY CULT
CFG	CF SPUTUM GRAM STAIN
ERC	CHEM 7
CX7	CHEM 7 MASTER
LVK	CHEM PANEL-LVK ONLY
RCJ	CHEMISTRY PROFILE
CSD	CHLAM SPECIES DIFF
CLA	CHLAMYDIA CULTURE
CPB	CHLAMYDIA DNA PROBE
CT	CHLAMYDIA FINAL RESULT
CTO	CHLAMYDIA OCULAR
RA1	CHLAMYDIA SP IGG AB'S
RCH	CHLORAL HYDRATE
CHL	CHLORAMPHENICOL
CL	CHLORIDE
UCL	CHLORIDE URINE
CLR	CHLORIDE URINE RANDOM
REQ	CHLORPROMAZINE
CHO	CHOLESTEROL
BCH	CHOLESTEROL, BODY FLUID
RER	CHOLINEST DIBUCAINE INHIB
RCG	CHOLYGLYCINE
CHR	CHROMIUM
RCX	CHROMIUM, URINE
CHA	CHROMOGRANIN A
AAS	CHROMOSOME AMNIO SCREEN
CBA	CHROMOSOME BLOOD ABBRV
CBS	CHROMOSOME BLOOD SCREEN
CMS	CHROMOSOME MARROW SCREEN
CSA	CHROMOSOME STUDIES AMNIO
CSB	CHROMOSOME STUDIES BLOOD
CSM	CHROMOSOME STUDIES MARROW
CST	CHROMOSOME STUDIES TISSUE
CSH	CHROMOSOME STUDIES TUMOR
CSV	CHROMOSOME STUDIES VILLI
CTA	CHROMOSOME TISSUE ABBRV
CTC	CHROMOSOME TISSUE CONFIRM
CHT	CHYLOMICRONS
RTG	CIMETIDINE
RCI	CIRCULATING IMMUNE COMPLX
CIT	CITRATE, URINE
CCP	CITRULLINE ANTIBODY
CK	CK
CKI	CK ISO ELECTROPHORESIS
CKC	CK TOTAL, REFLEX CKMB
MB	CKMB
MBC	CKMB
TBM	CLARITHROMYCIN SUSCEP
CI	CLINICAL INFORMATION
CLL	CLL BILL CYTOGEN
RB3	CLOMIPRAMINE
KLO	CLONAZEPAM
RCV	CLONIDINE (CATAPRES)
CLO	CLOTEST FOR H. PYLORI
CLZ	CLOZAPINE (CLOZARIL)
BUF	CMV - BUFFY COAT
CMV	CMV CULTURE
CDU	CMV DNA PCR URINE QUAL
CVD	CMV DNA QUANT BY PCR
CMR	CMV FINAL REPORT
JC1	CMV PRELIM 1
CMP	CMV PRELIMINARY REPORT
CH2	CMV,RUBELLA,HERPES(TORCH)
COT	CO-GM1 TRIAD AUTO AB
RTA	CO-RECEPTOR TROPISM ASSAY
CO2	CO2
COB	COBALT
COC	COCAINE METABOLITE SCREEN
ICO	COCAINE METABOLITE UR CON
REX	COCCIDIOMYCOSIS AB,CSF
REW	COCCIDIOMYCOSIS AB,SERUM
CCF	COCCIDIOMYCOSIS CF CSF
MCF	COCOCCIDIOMYCOSIS BY CF
ZZZ	CODE TEST
AGG	COLD AGGLUTININ
CAT	COLD AGGLUTININ TITER
NTX	COLLAGEN N-TELOPEPTIDE,UR
CAH	COLLECT AND HOLD IN LAB
C_M	COLLECTION METHODS
RCK	COLORADO TICK FEVER
AL4	COMP INHALENT PANEL
CME	COMP METABOLIC PANEL
C3	COMPLEMENT - C3
C4	COMPLEMENT - C4
RC7	COMPLEMENT 7
RC8	COMPLEMENT 8
RC9	COMPLEMENT 9
CH5	COMPLEMENT TOTAL (CH50)
RDC	COMPREHENSIVE DRUG ANALY
DSC	COMPREHENSIVE URN DRG SCR
CON	CONCENTRATION BILL ONLY
CFM	CONFIRM DISPATCH LABEL
IHP	CONFIRM HBA/HOB
CPL	COPPER, LIVER TISSUE
COP	COPPER, SERUM
RCQ	COPPER, URINE
COE	COPROPORPHYRINOGEN OX
CGA	CORD BLOOD GASES ARTERIAL
CGV	CORD BLOOD GASES VENOUS
CDH	CORD BLOOD HOLD SPECIMEN
CRD	CORD BLOOD WORKUP
CRN	CORN IGE ALLERGEN
CRT	CORTICOSTERONE
COR	CORTISOL
COG	CORTISOL BINDING GLOB
SCF	CORTISOL FREE SERUM
RCO	CORTISOL, REFERRED
RSC	CORTISOL,SALIVARY
RC1	COUMADIN
RCD	CREATINE, URINE
CRE	CREATININE
CC1	CREATININE CLEAR SERUM
CC	CREATININE CLEARANCE
UCR	CREATININE URINE
RCR	CREATININE URINE RANDOM
BCF	CREATININE, BODY FLUID
PCJ	CREUTZFELDT-JACOB DETCTOR
CRH	CRH STIMULATION TEST
CRG	CRYOGLOBULIN (QUAL)
RCL	CRYOGLOBULINS QUANT
CNF	CRYPTOCOCCAL AG MSTR CSF
CCS	CRYPTOCOCCAL AG SERUM
CCA	CRYPTOCOCCAL ANTIGEN CSF
CCM	CRYPTOCOCCAL ANTIGEN MSTR
CTS	CRYPTOCOCCAL TITER SERUM
CRI	CRYPTOSPOR EXAM,STOOL
CRY	CRYSTAL EXAM, BODY FLUID
CSC	CSF CHEMISTRIES MASTER
CSF	CSF CULTURE
CSX	CSF CULTURE MASTER
CSS	CSF SENSITIVITY
BSA	CULTURE, THROAT ROUTINE
CX3	CX-3 MASTER
CYN	CYANIDE, BLOOD
CYS	CYCLOSPORA EXAM
CYC	CYCLOSPORINE
CFX	CYSTIC FIBROSIS MASTER
RMC	CYSTIC FIBROSIS MOLECULAR
CYT	CYSTICERCOSIS AB, SERUM
RCE	CYSTINE QUANTITATIVE UR
CMB	CYTO/MICRO/UA SPLIT
C02	CYTOLOGY CSF
CMG	CYTOMEGALOVIRUS IGG AB
CTM	CYTOMEGALOVIRUS IGM
DD	D-DIMER
DDD	D-DIMER MASTER
DDS	D-DIMER, SEMIQUANTITATIVE
DLA	D-LACTATE ACID
RDY	D-XYLOSE ABS PEDIATRIC
RAL	DELTA AMNIOLEVULINIC ACID
RDO	DEOXYCORTICOSTERONE
RDE	DESIPRAMINE/REFERRED
DST	DEXAMETHASONE SUPPRESSION
DHE	DHEA SULFATE
DGM	DIALYSIS FLD GRAM STAIN
VLM	DIAZEPAM
VCF	DIGEORGE/VCF FISH
RDG	DIGITOXIN
DIG	DIGOXIN
RDI	DIHYDROTESTOSTERONE
RBW	DILANTIN FREE
RDA	DIPHTHERIA ANTITOXOID AB
DBB	DIRECT BILIRUBIN BABY
DAT	DIRECT COOMBS(DAT)
LDL	DIRECT LDL CHOL
DTI	DIRECT TISSUE IMMUNOFLNCE
DSU	DIURETIC SCREEN, URINE
DQU	DIURETICS PANEL, URINE
DMD	DMD/BMD MALE PROBAND
PRK	DNA EXTRACTION FOR STUDY
DOL	DOLICHOLS, URINE
DON	DONATH LANDSTEINER
RDP	DOXEPIN
DUX	DUCREYI CULTURE MASTR
UDY	DYSMORPHIC RBC SCREEN
ECC	E COLI O157:H7 CULTURE
EAR	EAR CULTURE
EAX	EAR CULTURE MASTR
EAS	EAR SUSCEPTIBILITY
ECG	ECG ORDER
ECW	ECHINOCOCCUS IGG WB
ECE	ECHINOCOCCUS IGG,ELISA
EGP	EGFR BY PCR
EGF	EGFR FISH
EWA	EGG WHITE IGE ALLERGEN
EYA	EGG YOLK IGE ALLERGEN
FLY	ELECTOLYTES, FECAL
ELC	ELECTROLYTE PANEL
DSS	EMERGENCY DEPT DRUG SCRN
EHS	EMPLOYEE HEALTH SCREEN
EAA	ENDOMYSIAL AB IGA
EDT	ENDOMYSIAL AB IGA TITER
ENS	ENTAMOEBA HISTOLYTICA AG
ENT	ENTAMOEBA HISTOLYTICA IGG
ENV	ENTEROVIRUS CULTURE
EPC	ENTEROVIRUS PCR,CSF
ERN	ENTEROVIRUS RNA BY PCR
EOS	EOS ABSOLUTE COUNT
EOM	EOSINOPHIL SMEAR,MISC.
UEO	EOSINOPHIL SMEAR,URINE
REB	EPSTEIN BARR AB PANEL
ERY	ERYTHROPOIETIN
REP	ERYTHROPOIETIN
GFR	EST GLOMERULAR FILTRATION
EST	ESTRADIOL
REU	ESTRIOL UNCONJUGATED
ESR	ESTROGEN TOTAL URINARY
EPR	ESTROGEN-PROGESTERONE REC
EFS	ESTROGENS FRACT SERUM
ETS	ESTROGENS, TOTAL
REF	ESTROGENS-FRACTIONATED
RA9	ESTRONE
RET	ETHANOL GEL TEST
IAL	ETHANOL URINE CONFIRM
ALU	ETHANOL, URINE
ZAR	ETHOSUXIMIDE
RDV	ETHYLENE GLYCOL
REG	EUGLOBULIN CLOT LYSIS TIM
XDF	EXTENDED DIFF
XBF	EXTRA BODY FLUID SPECIMEN
XGY	EXTRA CHEM GRAY TUBE
XGR	EXTRA CHEM GREEN SEP TUBE
XRD	EXTRA CHEM RD10 TUBE
XSS	EXTRA CHEM SS5 TUBE
XBL	EXTRA COAG BLUE TUBE
XSF	EXTRA CSF SPECIMEN
XLV	EXTRA HEME LAV TUBE
XSP	EXTRA SPUTUM SPECIMEN
XST	EXTRA STOOL SPECIMEN
XUR	EXTRA URINE SPECIMEN
XBC	EXTRA WHOLE BLOOD CHEM
XCB	EXTRA WHOLE BLOOD CHEM
EYE	EYE CULTURE
EYX	EYE CULTURE MASTER
EYS	EYE CULTURE SUSCEPTIBILIY
EYG	EYE GRAM STAIN
F8P	FACTOR 8 VON W PANEL
FBC	FACTOR B COMPLEMENT
F2A	FACTOR II ACTIVITY
FIX	FACTOR IX ACTIVITY
F9I	FACTOR IX COAG INHIB
F5A	FACTOR V ACTIVITY
F5M	FACTOR V MUTATION ASSAY
F7A	FACTOR VII ACTIVITY
FAC	FACTOR VIII ACTIVITY ONLY
F8A	FACTOR VIII ANTIGEN ONLY
F8I	FACTOR VIII COAG INHIB
FXA	FACTOR X ACTIVITY
FXI	FACTOR XI ACTIVITY
FX2	FACTOR XII ACTIVITY
FX3	FACTOR XIII ACTIVITY
FLD	FARMERS LUNG DISEASE
FBM	FASTING BASIC METABOLIC
FCM	FASTING COMP METABOLIC
FRF	FASTING RENAL FUNCTION
RFF	FECAL FAT QUANTITATIVE
FQL	FECAL FAT, QUALITATIVE
SWB	FECAL WBC
MWB	FECAL WBC -- RLB REFLEX
FLB	FELBAMATE
FEN	FENTANYL SCREEN
FER	FERRITIN
FFN	FETAL FIBRONECTIN
FSC	FETAL-MATERNAL SCREEN
FIB	FIBRINOGEN
JE	FINAL
FTS	FIRST TRIMESTER SCREEN
FIS	FISH
IFS	FISH SINGLE DNA BILL ONLY
HR2	FISH,HER2/NEU RFLX IHC
FK5	FK506 (TACROLIMUS)
RFL	FLECAINIDE
RAQ	FLUORIDE SERUM
RAW	FLUORIDE URINE
C09	FNA PALP MASS
C11	FNA THYROID
FRC	FOLATE RBC
FOL	FOLATE(ONLY FOLATE ORDER)
FSH	FOLICLE STIMULATION HORMO
FRM	FORM FOR BLOOD BANK
RFP	FREE ERYTHRO PROTOPORPHYN
T4F	FREE T4
FT4	FREE T4 BY DIALYSIS (REF)
FRU	FRUCTOSAMINE
FTR	FTA
FTA	FTA (HEARING LOSS)
FNA	FUNGUS BILL #1
FNJ	FUNGUS BILL #10
FNK	FUNGUS BILL #11
FNB	FUNGUS BILL #2
FNC	FUNGUS BILL #3
FND	FUNGUS BILL #4
FNE	FUNGUS BILL #5
FNF	FUNGUS BILL #6
FNG	FUNGUS BILL #7
FNH	FUNGUS BILL #8
FNI	FUNGUS BILL #9
FUN	FUNGUS CULTURE
FII	FUNGUS ISOLATE ID OHSU
FOS	FUNGUS ISOLATE SMEAR
FUS	FUNGUS SMEAR
BFN	FUNGUS SOURCE 3
HNS	FUNGUS SOURCE BILL 1
OFN	FUNGUS SOURCE BILL 2
RG6	G6PD
GAD	GAD-65 AUTOANTIBODIES
GGT	GAMMA GT
RB1	GANGLIOSIDE AB PANEL
RGA	GASTRIN
GCA	GC AMPLIFIED TEST
GC	GC CULTURE
GCX	GC CULTURE MASTER
NJ	GC/CHLAM PROBES
CPR	GC/CHLAMYDIA DNA PROBES
GCM	GC/GENITAL MASTER
RGM	GEMONIL (METHARBITAL)
P71	GEN YST
SSO	GENERIC STAT SEND-OUT
DFA	GENERIC VIRAL AG ID, DFA
GRW	GENETIC REFERRAL WORKLOAD
GEN	GENITAL CULTURE
GEX	GENITAL CULTURE MASTER
CGH	GENOMIC ARRAY ANALYSIS
GEP	GENTAMICIN PEAK
GER	GENTAMICIN RANDOM
GET	GENTAMICIN TROUGH
OP	GIARDIA SCREEN
RGL	GLIADIN ANTIBODY IGA
GAG	GLIADIN ANTIBODY IGG
RDB	GLOMERULAR BSMT MEM AB
RGC	GLUCAGON
G1P	GLUCOSE 1HR PRENATAL SCR
TT2	GLUCOSE 3H PRENATAL TOL
G2B	GLUCOSE ABBREV 2H
GAT	GLUCOSE ADDITIONAL TIMED
UGQ	GLUCOSE QUANTITATIVE UR
BGL	GLUCOSE, BODY FLUID
CGL	GLUCOSE, CSF
FBS	GLUCOSE, FASTING
GLU	GLUCOSE, NONFASTING
UGL	GLUCOSE,TEST STRIP URINE
GLY	GLYCOSYLATED HEMOGLOBIN
GPR	GONOCOCCUS DNA PROBE
N01	GRAM NEG ID #1
N10	GRAM NEG ID #10
N11	GRAM NEG ID #11
N12	GRAM NEG ID #12
N13	GRAM NEG ID #13
N14	GRAM NEG ID #14
N15	GRAM NEG ID #15
N16	GRAM NEG ID #16
N17	GRAM NEG ID #17
N19	GRAM NEG ID #19
N20	GRAM NEG ID #20
N21	GRAM NEG ID #21
N22	GRAM NEG ID #22
N23	GRAM NEG ID #23
N24	GRAM NEG ID #24
N05	GRAM NEG ID #5
NO5	GRAM NEG ID #5
N06	GRAM NEG ID #6
N07	GRAM NEG ID #7
N08	GRAM NEG ID #8
N09	GRAM NEG ID #9
N03	GRAM NEG ID#3
N04	GRAM NEG ID#4
N32	GRAM NEG REFLEX ID #32
N33	GRAM NEG REFLEX ID #33
N34	GRAM NEG REFLEX ID #34
N35	GRAM NEG REFLEX ID #35
N36	GRAM NEG REFLEX ID #36
N37	GRAM NEG REFLEX ID #37
N38	GRAM NEG REFLEX ID #38
N39	GRAM NEG REFLEX ID #39
N40	GRAM NEG REFLEX ID #40
N41	GRAM NEG REFLEX ID #41
N42	GRAM NEG REFLEX ID #42
N43	GRAM NEG REFLEX ID #43
N44	GRAM NEG REFLEX ID #44
N45	GRAM NEG REFLEX ID #45
N46	GRAM NEG REFLEX ID #46
N47	GRAM NEG REFLEX ID #47
N48	GRAM NEG REFLEX ID #48
N49	GRAM NEG REFLEX ID #49
N50	GRAM NEG REFLEX ID #50
N51	GRAM NEG REFLEX ID #51
N52	GRAM NEG REFLEX ID #52
N53	GRAM NEG REFLEX ID #53
N54	GRAM NEG REFLEX ID #54
N55	GRAM NEG REFLEX ID #55
N56	GRAM NEG REFLEX ID #56
N57	GRAM NEG REFLEX ID #57
N59	GRAM NEG REFLEX ID #59
N31	GRAM NEG REFLEX ID#31
P09	GRAM POS ID # 9
P01	GRAM POS ID #1
P10	GRAM POS ID #10
P11	GRAM POS ID #11
P12	GRAM POS ID #12
P02	GRAM POS ID #2
P03	GRAM POS ID #3
P04	GRAM POS ID #4
P42	GRAM POS ID #42
P05	GRAM POS ID #5
P07	GRAM POS ID #7
P08	GRAM POS ID #8
P41	GRAM POS REFLEX ID #41
P43	GRAM POS REFLEX ID #43
P44	GRAM POS REFLEX ID #44
P45	GRAM POS REFLEX ID #45
P46	GRAM POS REFLEX ID #46
P47	GRAM POS REFLEX ID #47
P48	GRAM POS REFLEX ID #48
P49	GRAM POS REFLEX ID #49
P50	GRAM POS REFLEX ID #50
P51	GRAM POS REFLEX ID #51
P52	GRAM POS REFLEX ID #52
P53	GRAM POS REFLEX ID #53
P54	GRAM POS REFLEX ID #54
P56	GRAM POS REFLEX ID #56
P58	GRAM POS REFLEX ID #58
P59	GRAM POS REFLEX ID #59
P60	GRAM POS REFLEX ID #60
P70	GRAM POS REFLEX ID #60
P61	GRAM POS REFLEX ID #61
P62	GRAM POS REFLEX ID #62
P63	GRAM POS REFLEX ID #63
P64	GRAM POS REFLEX ID #64
P65	GRAM POS REFLEX ID #65
P66	GRAM POS REFLEX ID #66
P67	GRAM POS REFLEX ID #67
P68	GRAM POS REFLEX ID #68
P69	GRAM POS REFLEX ID #69
CSG	GRAM STAIN CSF
GS	GRAM STAIN ONLY
GSR	GRAM STAIN ONLY REVIEW
CSR	GRAM STAIN REVIEW CSF
SPR	GRAM STAIN REVIEW SPUTUM
WNR	GRAM STAIN REVIEW WOUND
N02	GRAN NEG ID #2
GBP	GROWTH HORMONE BIND PRO
GHB	GROWTH HORMONE BIND PRO
GHS	GROWTH HORMONE GLU SUPP
RHE	H INFLU B VACCINE STATUS
HIA	H.INFLUENZAE TYPE B AG'S
RHO	HALOPERIDOL
HND	HANDLING FEE
HAP	HAPTOGLOBIN
HAC	HAS POS SAMPLE TO STATE
HZL	HAZELNUT IGE ALLERGEN
RHC	HCG QUANT/REFERRED
QCG	HCG SERUM QUANTITATIVE
CHC	HCG TUMOR MARKER CSF
UCG	HCG URINE
SUG	HCG URINE, SELF REFERRED
HDL	HDL CHOL
RBQ	HEAVY METALS GROUP, BLOOD
RBX	HEAVY METALS PANEL URINE
HNZ	HEINZ BODIES
HEI	HEIRS STUDY
HPA	HELICOBACTER PYLORI IGG
HCT	HEMATOCRIT ONLY
HTG	HEMATOCRIT, BLOOD GAS
HPM	HEME MASTER
P1	HEMOCARE PRODUCT
A1C	HEMOGLOBIN A1C
HGB	HEMOGLOBIN ONLY
RFH	HEMOGLOBIN, PLASMA
HEL	HEMOGLOBINOPATHY WORKUP
DUC	HEMOPHILUS DUCREYI
UHE	HEMOSIDERIN
HAS	HEP A AB, IGM
HAR	HEP A AB,TOTAL
HIG	HEP B CORE AB, IGM
HBC	HEP B CORE AB, TOTAL
HBG	HEP B GENOTYPE
HAB	HEP B SURFACE AB
QHB	HEP B SURFACE AB QUANT
HES	HEP B SURFACE AB(EMP SCR)
HBA	HEP B SURFACE AG
HOB	HEP B SURFACE AG (OB)
HCR	HEP C AB, REFLEX PCR
HCN	HEP C GENOTYPE
HCL	HEP C RNA PCR QUANT
HSC	HEP SCRN FOR MT CLINICIAN
HEP	HEPARIN ASSAY
RB5	HEPARIN PLATELET ANTIBODY
HFP	HEPATIC FUNCTION PANEL
HBM	HEPATITIS B CORE IGM
HBV	HEPATITIS B VIRAL DNA
HBE	HEPATITIS BE ANTIBODY
RBE	HEPATITIS BE ANTIGEN
HDA	HEPATITIS DELTA AG
RHD	HEPATITIS DELTA ANTIBODY
H2C	HER-2/NEU FISH COMMENT
JD	HERPES FINAL
HST	HERPES IGM AB TITER
JB	HERPES PRELIM 2
JC	HERPES PRELIM 3
REA	HERPES SIMPLEX 1&2 IGG
HER	HERPES SIMPLEX CULTURE
HRG	HERPES SIMPLEX IGM
HSV	HERPES SIMPLEX IGM
HSM	HERPES SIMPLEX PCR CSF
HSP	HERPES SIMPLEX VIRUS, PCR
PA1	HGB A1C (PEDIATRIC)
HH	HGB AND HCT
HGP	HIG POS SAMPLE TO STATE
HCC	HIGH SENS CARDIO CRP
RHA	HIPPURIC ACID
RHT	HISTAMINE
RHU	HISTAMINE, URINE 24HR
HMB	HISTOPATH/MICRO SPLIT
BX	HISTOPATHOLOGY
HIP	HISTOPLASMA ANTIBODY
HPG	HISTOPLASMA ANTIGEN
HVF	HIV 1 (IFA)
HVE	HIV 2 (EIA)
HGT	HIV GENOTYPING
HVL	HIV VIRAL LOAD
HWB	HIV-1 WB WITH REFLX HIV-2
HVA	HIV-1/2 SCREEN
HVP	HIV-1/2 AB PRENATAL
HVC	HIV-1/2 WESTERN BLOT
HW2	HIV-2 AB IMMUNOBLOT
RA0	HIV-DNA BY PCR ASSAY
RAT	HLA AB TYPING
RHS	HLA ANTIBODY SCREEN
RHL	HLA B27
RH5	HLA B5
RDR	HLA DR TYPING
HLA	HLA NEW PATIENT WORKUP
RDT	HLA PLATELET XMATCH
HCD	HLA, CELIAC DISEASE
DQW	HLA-DR2/DQW1
RHR	HLA-TYPING RECIPIENT
HOM	HOMOCYSTEINE
HMG	HOMOGENIZATION BILL ONLY
HNB	HONEY BEE IGE ALLERGEN
FFS	HPS FFS (BILL ONLY)
HPC	HPV COTEST HIGH RISK
HPV	HPV DNA, HIGH RISK, CX
HPS	HPV HIGH RISK
HTL	HTLV 1&2 SCRN RFLX WBLOT
HTW	HTLV 1&2 WESTERN BLOT
AN2	HU, YO, RI AB W/REFLEX
RHG	HUMAN GROWTH HORMONE
RPP	HYPER PNEUMONITIS PANEL
RRA	HYPERALDOSTERONISM SCREEN
IGA	IGA
IGE	IGE
IB3	IGF BINDING PROTEIN-3
SOM	IGF-1
IGG	IGG
HIS	IGG SUBCLASS 4
ISP	IGG SUBCLASS PANEL
IGM	IGM
IHC	IHC,HER2 WITH INTERP
IMP	IMIPRAMINE MASTER PANEL
RIM	IMIPRAMINE/REFERRED
IMS	IMMUNOGLOBULINS
IMM	IMMUNOGLOBULINS MASTER
IBF	IMMUNOGLOBULINS, BF MASTR
RI1	IMMUNOLOGY PANEL 1
BC1	INACTIVE BLD PRELIM 1
BC	INACTIVE ORDER BLC
INL	INDERAL (PROPRANOLOL)
LIH	INDICES
FPC	INFLUENZA A,H1N1,B PCR
INF	INFO FOR MSAFP SCREEN
INH	INHIBIN A
INI	INSECT IDENTIFICATION
IVP	INSECT VENOM IGG
POI	INSECTICIDE POISONING
INS	INSULIN
INA	INSULIN ANTIBODIES
I05	INSULIN ARGININE 105 MIN
I20	INSULIN ARGININE 120 MIN
I35	INSULIN ARGININE 135 MIN
I15	INSULIN ARGININE 15 MIN
I50	INSULIN ARGININE 150 MIN
I30	INSULIN ARGININE 30 MIN
I45	INSULIN ARGININE 45 MIN
I60	INSULIN ARGININE 60 MIN
I75	INSULIN ARGININE 75 MIN
I90	INSULIN ARGININE 90 MIN
IAS	INSULIN ARGININE BASELINE
REC	INSULIN TOLERANCE
ISF	INSULIN, FREE
IFN	INTERPHASE FISH
RIF	INTRINSIC FACTOR BLK AB
RIT	IODINE TOTAL
RUI	IODINE, 24 HR URINE
CAI	IONIZED CALCIUM
ICA	IONIZED CALCIUM
ICS	IONIZED CALCIUM "STAT"
TIB	IRON + TIBC
RIR	IRON AND TIBC/REFERRED
IRN	IRON, ER
IRL	IRON, LIVER TISSUE
RIU	IRON, URINE
RA3	ISLET CELL AB
RII	ISOCYANATE IMMUNOASSAY
ISH	ISOHEMAGGLUTININ TITER
ISO	ISONIAZID, SERUM
RIP	ISOPROPANOL
ISS	ISOSPORA EXAM
ITZ	ITRACONAZOLE
JEX	JAK EXON 12,13,REFLEX MPL
J12	JAK2 EXONS 12,13 QUAL
JMP	JAK2 MPL W515, S505 QUAL
JKQ	JAK2 QUAL RFL EX12,13
JKM	JAK2 RFL EX 12,13 AND MPL
JPV	JC POLYOMA VI DNA,QN PCR
JNT	JOINT FLUID CULTURE
JNX	JOINT FLUID CULTURE MASTR
JFG	JOINT FLUID GRAM STAIN
JNS	JOINT FLUID SENSITIVITY
MKL	KAP/LAM LT CH FREE/RATIO
KB	KLEIHAUER BETKE
KOH	KOH PREPARATION
KPR	KPRR DRUG PANEL
KSO	KRAS, ONLY
HCS	KSC ONLY SCREEN HCG
SAA	LAB GUIDE,ASSAULT/ABUSE
LBX	LAB USE TSR
TTX	LAB USE TSR.
LAV	LACTATE PLASMA
LTT	LACTOSE TOLERANCE TEST
LBC	LAMELLAR BODY COUNTS
LTG	LAMOTRIGINE
LTX	LATEX IGE ALLERGEN
LD	LD
LDI	LD ISOENZYME ELECTROPHOR
BLD	LD, BODY FLUID
PB	LEAD - BLOOD
LEA	LEAD, URINE
LGU	LEGIONELLA AG, URINE
RLA	LEGIONELLA ANTIBODY
RB8	LEGIONELLA DFA
LPT	LEPTIN
LAD	LEUKOCYTE ADHESION DEF
ULE	LEUKOCYTE ESTERASE,URINE
KEP	LEVETIRACETAM (KEPPRA)
LIC	LICE EXAM
RLD	LIDOCAINE
P13	LIM WORKUP
AL3	LIMITED INHALENT PANEL
LAL	LIMULUS AMEBOCYTE LYSATE
RLI	LIPASE
RLP	LIPASE
FAS	LIPID FASTING STATUS
LPR	LIPID PANEL, FASTING
LPN	LIPID PANEL,NONFASTING
LSC	LIPID SCREEN
RLE	LIPOPROTEIN ELECTROPHORES
RBP	LIPOPROTEIN ULTRA CENTRIF
LPA	LIPOPROTEIN(A)
LI	LITHIUM
LFT	LIVER FUNCTION PROF
LKM	LIVER/KIDNEY MICROSOME
RA4	LORAZAPAM
RA5	LSD QUANT, UR
LSD	LSD SCREEN UR, REFLEX QNT
LBT	LUPUS BAND TEST
RLU	LUPUS INHIBITOR ANTICOAG
LUP	LUPUS INHIBITOR EVAL
LH	LUTEINIZING HORMONE
LYW	LYME AB WEST BLOT PANEL
LYL	LYME DISEASE AB LATE
LYM	LYME DISEASE ANTIBODY
RI2	LYMPH AG PROLIF ANALYSIS
RL2	LYMPH MIT PROLIF ANALYSIS
RL1	LYMPH SCREEN I
RLZ	LYSOZYME URINE
RLY	LYSOZYME, SERUM
DLY	LYTES-DIALYSATE
MBP	M.TUBERCULOSIS,DNA,PCR
MNA	MACADAMIA NUT IGE ALLERG
MPL	MACROPROLACTIN SCREEN
MG	MAGNESIUM
MGU	MAGNESIUM, URINE
BPC	MALARIA CONFIRMATION
BPM	MALARIA MASTER PANEL
REY	MANGANESE
P15	MANITIOL SALT STAPH WRKUP
DIF	MANUAL DIFFERENTIAL
RA6	MAST PANEL FOOD/MOLD IGE
RMI	MBC**
MDS	MDS BILL CYTOGEN
MED	MECONIUM DRUG SCREEN
RMT	MEPHENYTOIN
MEP	MEPHOBARBITAL/PHENOBARB
RMP	MEPROBAMATE
MEC	MERCURY, BLOOD
MEU	MERCURY, URINE
MET	METANEPHRINES
PME	METANEPHRINES, PLASMA
MES	METHADONE SCREEN
IME	METHADONE URINE CONFIRM
RML	METHANOL, BLOOD
MLU	METHANOL, URINE
MAR	METHARBITAL
MHB	METHEMOGLOBIN
MEX	METHOTREXATE
MAU	METHYLMALONIC ACID UR
MAS	METHYLMALONIC ACID,SERUM
MTP	MICRO TRACKING
UMS	MICROALB/UR CREAT RATIO
UMQ	MICROALBUMIN 24HR URINE
MBS	MICROBIOLOGY SPECIMEN
MSI	MICROSATELLITE INSTABIL
MSP	MICROSPORIDIA, STOOL
MLK	MILK IGE ALLERGEN
MVC	MISC VIRAL CULTURE
JJ	MISC VIRAL PRELIM 2
JK	MISC VIRAL PRELIM 3
RMX	MIXED LYMPHOCYTE CULTURE
MXA	MIXING STUDY, APTT
MXP	MIXING STUDY, PT
MCV	MOLEC CANAVAN DISEASE
CMT	MOLEC CMT PROFILE
C1A	MOLEC CMT1A
C1B	MOLEC CMT1B
CX1	MOLEC CMTX1
MDR	MOLEC DRPLA
MFA	MOLEC FRIEDREICH ATAXIA
MHD	MOLEC HUNTINGTON DISEASE
MKD	MOLEC KENNEDY DISEASE
MEL	MOLEC MITOCHONDRIAL MELAS
MER	MOLEC MITOCHONDRIAL MERRF
NAR	MOLEC MITOCHONDRIAL NARP
SC1	MOLEC SCA1
SC2	MOLEC SCA2
SC3	MOLEC SCA3
SC6	MOLEC SCA6
SC7	MOLEC SCA7
SMA	MOLEC SPINAL MUSCULAR ATR
MTS	MOLEC TAY-SACHS DISEASE
BCQ	MOLECULAR BCR/ABL QUANT
MDB	MOLECULAR DNA BANKING
FRX	MOLECULAR FRAGILE X DNA
HCH	MOLECULAR HEMOCHROMATOSIS
MDY	MOLECULAR MYOTONIC DYSTRO
MON	MONO
MCP	MONOCLONAL PROTEIN
RBC	MORPHOLOGY LAB REFLEXED
N61	MOT PANEL
MRS	MRSA GX DNA PCR SCREEN
OXX	MRSA SCREEN CULTURE MASTR
OXS	MRSA SCREEN SENSITIVITY
OXR	MRSA SCREENING CULTURE
MAP	MSAFP SCREEN
MTR	MTHFR MUTATION ANALYSIS
RMS	MULTIPLE SCLEROSIS PANEL
RMM	MUMPS IGG AB
MUM	MUMPS TITER, IGM
VCM	MUMPS VIRAL CULTURE
VCU	MUMPS VIRAL CULTURE URINE
MUS	MUSCLE BIOPSY
MTB	MYCOBACTERIA DNA PROBE
MCA	MYCOPHENOLIC ACID
MPR	MYCOPLASMA PCR
MYT	MYCOPLASMA PNEUMONIAE IGG
MYC	MYCOPLASMA PNEUMONIAE,IGM
UCC	MYCOPLASMA/UREAPLASMA CLT
RB0	MYELIN ASSOCIATED GLYCOPR
RMB	MYELIN BASIC PROTEIN
MYL	MYELOMA BILL CYTOGEN
UMY	MYOGLOBIN SCREEN URINE
MYQ	MYOGLOBIN,QUANT, UR
NAD	NADH - DIAPHORASE
NAP	NAPA
NOC	NASAL (NOSE) CULTURE
NOX	NASAL (NOSE) CULTURE
NOS	NASAL SUSCEPTIBILITY
NPC	NASOPHARYNGEAL CULTURE
NPX	NASOPHARYNGEAL MASTER
NPS	NASOPHARYNGEAL SENSITIVIY
BCN	NEGATIVE BC FINAL
LST	NEOGEN WORKLIST ONLY
NDS	NEONATAL DRUG SC/REFERRED
NTH	NEONATAL THROMBOCYTOPENIA
NE1	NEPHROLOGY PHOS
NE6	NEPHROLOGY PROF
RBT	NEURL NUC(HU)AB RFX WB/TI
NSE	NEURON SPFC ENOLASE
DHR	NEUTROPHIL OXIDATIVE
RPR	NEW CODE FOR RPR
WNB	NEWBORN SCREEN-WASH.ST.
NBS	NEWBORN SCREENING
NIS	NICKEL, SERUM
NIC	NICKEL,24 HOUR URINE
NIU	NICOTINE AND COTININE, UR
UNI	NITRITE,URINE
NBT	NITROBLUE TETRAZOLIUM
MOD	NOCARDIA SCREEN
RA7	NORTHWEST INHALENT PANEL
NOR	NORTRIPTYLINE
RNO	NORTRIPTYLINE/REFERRED
NMP	NUCLEAR MATRIX PROTEIN 22
RNU	NUCLEOTIDASE
NUT	NUTRITION MASTER
OBP	OB A1C/FRUCTOSAMINE PANEL
OBC	OB STREP SCREEN
OBG	OB STREP SCREEN MASTER
OBS	OB STREP SCREEN SENSI
OH1	OCC HEALTH PANEL 1
OCB	OCCULT BLOOD -OTHER
OCG	OCCULT BLOOD, BODY FLUID
OPC	OHSU PAIN CLINIC DRUG SCR
ODX	ONCOTYPE DX
OPI	OPIATE SCREEN
IOP	OPIATES/OXYS UR CONFIRM
OAP	ORGANIC ACIDS, PLASMA
ROA	ORGANIC ACIDS-URINE
IOD	ORGANIC BASE DRUG CONF
OBD	ORGANIC BASE DRUG SCREEN
ORB	ORGANIC BASE WORKLIST
UOS	OSMOLALITY URINE
SOS	OSMOLALITY, SERUM
OSS	OSMOLALITY, STOOL
REK	OSMOTIC FRAGILITY-RBC
ROV	OVARIAN ANTIBODY
ROU	OXALATE URINE
TLP	OXCARBAZEPINE METAB
OXY	OXYCODONE SCREEN
O2S	OXYGEN STATUS
RAY	P24 ANTIBODY
RAX	P24 ANTIGEN
RDD	PANCREATIC POLYPEPTIDE
PLM	PAP LIQUID MONITOR
PLS	PAP LIQUID SCREEN
PAM	PAP SMEAR MONITOR
PAP	PAP SMEAR SCREEN
PWA	PAPER WASP IGE ALLERGEN
RPD	PARADIONE
PAC	PARANEOPLASTIC AUTOAB CSF
PAS	PARANEOPLASTIC AUTOAB SER
BPA	PARASITE EXAM - BLOOD
PAR	PARASITE EXAM COMPREHENSV
PXT	PAROXETINE (PAXIL)
PNH	PAROXYSMAL NOCT HEMOGLBUR
PBC	PARVOVIRUS B19 IGG AB
PGG	PARVOVIRUS B19 IGG AB
PGM	PARVOVIRUS B19 IGM AB
RPV	PARVOVIRUS B19 IGM AB
PVP	PARVOVIRUS B19, PCR
PRV	PATHOLOGIST REVIEW
REV	PB SMEAR INTERP
PEA	PEANUT IGE ALLERGEN
PEC	PECAN IGE ALLERGEN
PE2	PEDIATRIC ESTRADIOL
PFH	PEDIATRIC FSH
PLH	PEDIATRIC LH
RPM	PEMOLINE
RPJ	PENICILLIN G & V
RBR	PENTACHLOROPHENOL
RBS	PENTOBARBITAL
PPZ	PERPHENAZINE (TRILAFON)
PED	PERTUSSIS DFA
PCC	PERTUSSIS DNA, PCR
RDM	PERTUSSIS IGA/IGM
PER	PERTUSSIS SWAB CULTURE
ADP	PFT REFLEX ADP
BPH	PH, BODY FLUID
PPH	PH,PLEURAL FLUID
SPH	PH,STOOL
UPH	PH,URINE
RPG	PHAGOCYTOSIS ASSAY
RPH	PHENACEMIDE
IPH	PHENCYCLIDINE CONFIRM UR
PHE	PHENOBARBITAL
SPL	PHENOLPHTHALEIN,STOOL
RPX	PHENSUXIMIDE
PHL	PHENYLALANINE, OPHL STUDY
PNY	PHENYLALANINE, PLASMA
PTN	PHENYTOIN
VNP	PHLEBOTOMY DRAW
PHO	PHOSPHORUS
UPO	PHOSPHORUS URINE
RPO	PHOSPHORUS URINE RANDOM
PTA	PHYTANIC ACID
PAL	PINE NUT IGE ALLERGEN
PIN	PINWORM PREP
PST	PISTACHIO IGE ALLERGEN
RA2	PLACENTAL LACTOGEN (HPL)
PAI	PLASMINOGEN ACT INHIB
RA8	PLASMINOGEN ACTIVITY
RDQ	PLATELET ANTIBODY SCREEN
PFT	PLATELET FUNCTION TEST
PDI	PLT AB'S DIRECT/INDIRECT
PLT	PLT COUNT ONLY
PMA	PM SCL ANTIBODY
PCT	POC ACT CLOTTING TIME
PBG	POC BLOOD GASES ARTERIAL
PCG	POC BLOOD GASES CAP/MIXED
PVG	POC BLOOD GASES VENOUS
PBN	POC BUN
PCL	POC CHLORIDE
PCO	POC CO2
CAG	POC CORD BLD GAS ARTERIAL
CVG	POC CORD BLD GAS VENOUS
PCR	POC CREATININE
PEL	POC ELECTROLYTES
GPC	POC GLUCOSE BLOOD
PHT	POC HEMATOCRIT
PHG	POC HEMOGLOBIN
PIC	POC IONIZED CALCIUM
PLC	POC LACTATE
PMP	POC METABOLIC PANEL
PSK	POC POTASSIUM
PNA	POC SODIUM
RBB	POLIO AB 1-2-3
BFD	POLYETHEYLENE DEBRIS, BF
PQU	PORPHOBILINOGEN QUANT UR
PQS	PORPHOBILINOGEN SCREEN UR
SPO	PORPHYRIN QUAL,STOOL
RPU	PORPHYRIN QUANT 24 HR UR
UPP	PORPHYRIN QUANT RANDOM UR
POR	PORPHYRIN SCREEN, RBC
RPS	PORPHYRINS 24 HOUR STOOL
PFE	PORPHYRINS, FRAC, ERYTH
BCP	POSITIVE BC PANEL
SK	POTASSIUM
UK	POTASSIUM URINE
RUK	POTASSIUM URINE RANDOM
SKW	POTASSIUM WHOLE BLOOD
KST	POTASSIUM, STOOL
MPW	PRADER-WILLI METHYLATION
PMS	PRE-MARITAL SEROLOGY
PAB	PREALBUMIN
PIH	PREG HYPERTENS PROF
RAO	PREGNANEDIOL
PGN	PREGNANETRIOL
PNN	PREGNANETRIOL UR, PEDS
BPB	PRELIM MALARIA
PSC	PRENATAL AB SCREEN
MSA	PRENATAL SCREEN AFP ONLY
PTS	PRENATAL TYPE AND SCREEN
TRP	PRIMARY TRANSPLANT CHEM
PRI	PRIMIDONE/PHENOBARB
PRO	PROCAINAMIDE
PRR	PROCAINAMIDE/REFERRED
PNS	PRODUCT NO SPECIMEN
PRG	PROGESTERONE
RPF	PROINSULIN
PRL	PROLACTIN
APM	PROMETAPHASE ANALYSIS
IPR	PROPOXYPHENE CONFIRM UR
PC3	PROSTATE CA ANTIGEN 3, UR
RPC	PROTEIN C
RPN	PROTEIN S
RUP	PROTEIN URINE RANDOM
BFP	PROTEIN, BODY FLUID
CFP	PROTEIN, CSF
UPR	PROTEIN,TEST STRIP URINE
PTM	PROTHROMBIN GENE MUTATION
PT	PROTIME
PWB	PROTIME, WHOLE BLOOD
PTC	PROTIME/COUMADIN
RVV	PROTRIPTYLINE
PSM	PSA TOTAL MONITORING
PSA	PSA TOTAL, SCREEN
MPS	PSA, FREE PSA MASTER
PSU	PSA, ULTRASENSITIVE
COM	PT/APTT PANEL MASTER
CPH	PTH CYST FLUID
PTH	PTH INTACT
PIO	PTH INTRAOPERATIVE
PIA	PTH INTRAOPERATIVE ADD
RB9	PTH RELATED PROTEIN
PCA	PURKINJE CYTOPLASMIC AB
RPY	PYRUVATE KINASE
RQF	Q FEVER PHASE I AND II
N60	QUAD FERM
QTB	QUANTIFERON TB GOLD
QUI	QUINIDINE
QUR	QUINIDINE/REFERRED
RIN	R/O INFLUENZA
RAF	RA FACTOR SYNOVIAL FLUID
RTT	RABIES VIRUS ANTIBODY
RIC	RAJI CELL ASSAY
URM	RANDOM URINE MASTER
RMY	RAPAMYCIN (SIROLIMUS)
RIV	RAPID HIV TEST
RRC	RED CELL CHOLINESTERASE
RBD	RED CELL ENZYME
SRE	REDUCING SUBSTANCES,STOOL
RZZ	REFERRED TEST
RFN	RENAL FUNCTION PANEL
RRN	RENIN
MRA	RESPIRATORY AG PANEL
CFS	RESPIRATORY CULT SENS (CF
SPT	RESPIRATORY CULTURE
SPX	RESPIRATORY CULTURE MASTR
SPS	RESPIRATORY CULTURE SENS
PRA	RESPIRATORY DFA
JF	RESPIRATORY PRELIM 2
JG	RESPIRATORY PRELIM 3
RES	RESPIRATORY VIRAL CULTURE
ARE	RETIC AUTO
MRE	RETIC MANUAL
RA	RHEUMATOID FACTOR
RHI	RHIG (IF INDICATED)
RHX	RHIG ISSUE ONLY
D1	RHOGAM ISSUE
ARP	RIBOSOMAL P AB
RTN	RITALIN (METHYLPHENIDATE)
ROT	ROTAVIRUS
RSV	RSV (VIRUS)
RS	RSV/REFERRED
RUB	RUBELLA IGG AB STATUS
RRM	RUBELLA IGM
RUG	RUBEOLA IGG AB
RDN	RUBEOLA IGM SPECIFIC
RPK	S PNEUMONIAE IGG AB PANEL
SAP	SA MRSA PCR BILL PANEL
SLM	SALEM PANEL (SALEM ONLY)
SAL	SALICYLATE
SMT	SALMONELLA TITER
SCA	SCABIES/MITE EXAM
RSA	SCL-70 (SCLERODERMA AB)
MSQ	SECOND TRIMESTER SCREEN
SED	SED RATE
RSL	SELENIUM
RBH	SELENIUM URINE
MEN	SEMEN ANALYSIS 2ND PART
SEM	SEMEN ANALYSIS FIRST PART
SAC	SEMEN ANALYSIS, COMPLETE
SPV	SEMEN ANALYSIS, POSTVAS.
SPE	SER PROT ELECTROPHORESIS
SES	SEROTONIN, BLOOD
SRT	SERTRALINE
SIM	SERUM IMMUNOFIXATION
RBI	SEX HORMONE BINDING GLOBN
SEZ	SEZARY CELLS TRACKING
N70	SHIGATOXIN
SHA	SHRIMP IGE ALLERGEN
RSI	SIA/SBA PEAK
RSB	SIA/SBA TROUGH
SC	SICKLE CELL SCREEN
SIL	SILICONE ANTIBODIES
REH	SINGLE AMINO ACID QT PLAS
SIN	SINUS CULTURE
SIX	SINUS CULTURE MASTER
SIG	SINUS GRAM STAIN
SIS	SINUS SUSCEPTIBILITY
RSJ	SJOGRENS ANTIBODIES
SLI	SLIDE FOR OFFICE
SMF	SMITH-MAGENIS FISH
NFG	SNF FASTING GLUCOSE
NRG	SNF RANDOM GLUCOSE
NA	SODIUM
UNA	SODIUM URINE
RNA	SODIUM URINE RANDOM
NAW	SODIUM WHOLE BLOOD
NAS	SODIUM, STOOL
RBJ	SOMA
SYA	SOYBEAN IGE ALLERGEN
ASS	SPECIAL STAIN
USG	SPECIFIC GRAVITY,URINE
RSP	SPERM ANTIBODIES
IUI	SPERM WASH -- IUI
SPM	SPORDI MASTER
SHO	SPUN HCT ONLY
SPG	SPUTUM GRAM STAIN
AO	STAIN, ACRIDINE ORANGE
II	STAIN,INDIA INK
PNE	STAIN,PNEUMOCYSTIS
SSG	STAPH CULTURE GRAM STAIN
SSC	STAPH SCREEN CULTURE
SSX	STAPH SCREEN MASTER
SSS	STAPH SCREEN SENSITIVITY
RBK	STELAZINE
STE	STERILITY CULTURE
STX	STERILITY CULTURE MASTER
FIO	STL OCC BLD, IA OUTREACH
STL	STOOL CULTURE
SCD	STOOL CULTURE MASTER
SCS	STOOL SENSITIVITY
RSD	STORAGE DISEASE WORKUP
SPC	STREP B,OB,DNA,PCR,REFLEX
RST	STREP TEST,RAPID
ASO	STREPTOCOCCAL AB SCREEN
RSR	STRIATED MUSCLE AB
RSE	STYRENE EXPOSURE PROFILE
SUB	SUBSTANCE ANALYSIS
RSF	SULFADIAZINE
STA	SULFATIDE ANTIBODY
SLF	SULFONYLUREAS SCREEN
SMM	SURF MARK TRACKING,BM
TSM	SURF MARK TRK, TISSUE/BF
RTB	SURFACE MARKER TRACKING
TB	SUSCEPTIBILITY TB
SWT	SWEAT CHLORIDE
SHL	SYNERGY HI-LO RESISTANCE
STK	SYNERGY TIME KILL 1-2 DRG
SYP	SYPHILIS SEROLOGY
SYR	SYRINGE ANALYSIS
TCC	T CELL CLONALITY BY PCR
RF3	T3 FREE, TRACER DIALYSIS
REE	TAY SACHS CARRIER,SERUM
TSL	TAY-SACHS CARRIER WB
RGD	TBI IMMUNOGLOBULIN
T2C	TEST CK/TRO MASTER
22K	TESTING CK
XXY	TESTING LATE
22M	TESTING MASTER CK/TRO
XXZ	TESTING OUTSTANDING
22T	TESTING TRO
TES	TESTOSTERONE
RFT	TESTOSTERONE,FREE & TOTAL
RTE	TETANUS ANTITOXOID AB
RTL	THALLIUM, BLOOD
RTU	THALLIUM, URINE
THC	THC QUANTITATIVE
TQM	THC/CR MASTER PANEL
THE	THEOPHYLLINE
THI	THIOCYANATE
THM	THIOPURINE METABOLITES
RTZ	THIORIDAZINE
RNV	THIOTHIXENE (NAVANE)
TRC	THROAT CULTURE COMPLETE
TRM	THROAT CULTURE COMPLETE
TRS	THROAT SUSCEPTIBILITY
TCT	THROMBIN CLOTTING TIME
THY	THYROGLOBULIN
ATA	THYROGLOBULIN ANTIBODY
TCF	THYROGLOBULIN CYST FLUID
MAB	THYROID PEROXIDASE AB
RTS	THYROID STIM IMMUNOGLOB
RTH	THYROXINE BINDING GLOBULN
TIA	TIAGABINE
EMA	TIS TRANSGLUTAMINASE IGA
TTG	TIS TRANSGLUTAMINASE IGG
TSS	TISSUE CULT SENSITIVITY
TSU	TISSUE CULTURE
TSX	TISSUE CULTURE MASTER
TIG	TISSUE GRAM STAIN
TIF	TISSUE IMMUNOFLUORESCENCE
TOP	TOBRAMYCIN PEAK
TOB	TOBRAMYCIN RANDOM
TOT	TOBRAMYCIN TROUGH
TOC	TOCAINIDE
TMX	TOPIRAMATE (TOPOMAX)
TOR	TORCH NEONATAL INF. GRP
TFP	TOTAL & FREE PSA
TBB	TOTAL BILIRUBIN BABY
TNC	TOTAL NUCLEATED CELL CT
TP	TOTAL PROTEIN
TT3	TOTAL T3
TID	TOX ID MASTER PANEL
TOX	TOXICOLOGY MASTER PANEL
TAM	TOXOPLASMA IGM
TGM	TOXOPLASMA IGM
TSF	TOXOPLASMOSIS CSF
TAI	TOXOPLASMOSIS IGG
TLT	TOXOPLASMOSIS LOW TITER
C12	TRACKING CSF CYTOLOGY
C10	TRACKING FNA,NON-GYN CYTO
GYN	TRACKING GYN CYTOLOGY
STR	TRACKING PATHOLOGY, SURG
C03	TRACKING URINE CYTOLOGY
TRN	TRANSFERRIN
TRX	TRANSFUSION RX WORKUP
TRA	TRANXENE
REM	TRAZODONE
TPA	TREPONEMA PALLIDUM IGM
TYS	TRICH,YEAST AND BV EXAM
RTR	TRICHINELLA ANTIBODY
TAU	TRICHLORACETIC ACID, UR
ITC	TRICYCLIC CONFIRM UR
RTD	TRIDIONE
TRI	TRIGLYCERIDES NONFASTING
BTR	TRIGLYCERIDES, BODY FLUID
TRF	TRIGLYCERIDES-FASTING
RRT	TRIHEXYPHENIDYL
RT3	TRIIODOTHYRONINE
RBL	TRIMIPRAMINE
TRO	TROPONIN-I
RTY	TRYPSIN STOOL QUALITATIVE
TRY	TRYPSIN, SERUM
TPT	TRYPTASE
RAZ	TRYPTOPHAN
RAI	TRYPTOPHAN, URINE
TSH	TSH
TSR	TSH REFLEX FREE T4
TXM	TYPE AND CROSSMATCH
TSC	TYPE AND SCREEN
U5	UA (CHEMSTRIP ONLY)
U1	UA (CULTURE IF INDICATED)
UZ1	UA MASTER (CULT IF IND)
U2	UA MICROSCOPIC
UCO	UR CHEMSTRIP ONLY MASTER
UC1	UR CREAT FOR CFU
TH1	UR CREAT FOR TOX
UP1	UR PROTEIN, UPE
RUN	UREA NITROGEN UR. RANDOM
UUN	UREA NITROGEN,URINE
BUR	UREA, BODY FLUID
UUC	UREAPLASMA UREALYTIC CLT
URA	URIC ACID
UUA	URIC ACID URINE
RUA	URIC ACID URINE RANDOM
BUA	URIC ACID, BODY FLUID
U3	URINALYSIS (NO CULTURE)
URN	URINE CULTURE
URX	URINE CULTURE MASTER
CFU	URINE FREE CORTISOL
P76	URINE POS ID #2
P77	URINE POS ID #3
P79	URINE POS ID #5
P80	URINE POS ID #8
UPE	URINE PRO ELECTROPHORESIS
PES	URINE PROT ELECTRO,RANDOM
UPC	URINE PROTEIN /CRE RANDOM
UPQ	URINE PROTEIN QUANTITATED
URE	URINE REDUCING SUBSTANCES
URS	URINE SENSITIVITY
RAH	URINE UROBILINOGEN QUANT
P81	URINE YEAST PANEL
UUR	UROBILINOGEN,URINE
P75	UTINE ID POS#1
VAL	VALPROIC ACID
RVA	VALPROIC ACID/REFERRED
VAP	VANCOMYCIN PEAK
VAN	VANCOMYCIN RANDOM
VAT	VANCOMYCIN TROUGH
VAG	VARICELLA IGM
VZ	VARICELLA ZOSTER CULTURE
VAR	VARICELLA ZOSTER IGG
RVI	VASOACTIVE INTEST POLYPEP
VDR	VDRL, CSF
VEN	VENIPUNCTURE METHOD
VNF	VENIPUNCTURE METHOD,SNF
VOC	VERBAL ORDER CONFRIM
VLC	VERY LONG CHAIN F ACIDS
VIB	VIBRIO CULTURE
VSA	VIRAL STUDIES, ACUTE
VSC	VIRAL STUDIES, CONVALESNT
VDI	VIRUS DEFINITIVE ID
VIS	VISCOSITY
VIA	VITAMIN A
VB1	VITAMIN B1 (THIAMINE)
VBB	VITAMIN B12 BND CAPACITY
VB6	VITAMIN B6
VIC	VITAMIN C
D25	VITAMIN D,25 HYDROXY
VID	VITAMIN D-1,25 DIHYDROXY
VIE	VITAMIN E
RVM	VMA (VANILLYLMANDELIC A)
FRA	VON W FACTOR ACTIVITY
F8X	VON WILL FACTOR MULTIMERS
VOR	VORICONAZOLE LEVEL
VRR	VRE SCREEN CULTURE
VRX	VRE SCREEN MASTER
VRS	VRE SCREEN SENSITIVITY
JY	VZ PRELIM 2
JZ	VZ PRELIM 3
WLA	WALNUT IGE ALLERGEN
WHA	WHEAT IGE ALLERGEN
WFH	WHITE FACED HRNT IGE ALRN
WIF	WILLIAMS FISH
HID	WORKLOAD HPLC ID
WMI	WORM IDENTIFICATION
WAN	WOUND ANA BILLING
WND	WOUND CULTURE
WNG	WOUND CULTURE GRAM STAIN
WNX	WOUND CULTURE MASTER
WNS	WOUND SENSITIVITY
RBM	XANAX
BF	XB12/FOLATE(HOMOCYSTEINE)
F24	XFECAL FAT 24 HR QUANT
F48	XFECAL FAT 48 HR QUANT
SP1	XTOTAL PROTEIN FOR SPE
UC2	XUR CREAT FOR THC
XAC	XX ACTIVATED CLOT TIME
PHB	XX BLOOD, PH
X15	XX CA 15-3
CIS	XX CHROMSOME INSTABILITY
RE1	XX CYCLIC AMP
DGT	XX DNA GENETIC TESTING
DGA	XX DNA TESTING AMNIO FLD
DER	XX DRUG EXPAN SEDATIVE SC
DSR	XX DRUG SCREEN SEDATIVES
XG2	XX GTT 2 HOUR ABRIEV
XG1	XX GTT 2HR ROUTINE
XHA	XX HEP A AB IGG
XLD	XX LEGIONELLA DNA PROBE
XNB	XX NEUT BACTERICIDAL AS
XSZ	XX STREPTOZYME
XSN	XX SUSEPTIBILITY
RDS	XX URINE DRUG SCREEN/REF
HAM	XXACID HEMOLYSIN (HAM)
CAL	XXALBUMIN, CSF
RB4	XXAMIODARONE
RSY	XXANA (SYNOVIAL FLUID)
ACA	XXANTI-CENTROMERE AB
DNT	XXANTI-NDNA TITER
MIC	XXANTIB.SENS.AERO MIC/MBC
MIF	XXANTIBIO.SENS.MIC.FUNG
BAG	XXBACT AG DETECTION CSF
UBI	XXBILIRUBIN,URINE
BT	XXBLEEDING TIME, SIMPLATE
ABG	XXBLOOD GAS MASTER
LPG	XXBLOOD GAS MED OFFICE
BC3	XXBODY FLUID C3
BC4	XXBODY FLUID C4
RKF	XXCAFFEINE LEVEL
CAU	XXCARBAMAZEPINE, UNBOUND
CDP	XXCHLORDIAZEPOXIDE, SERUM
BCL	XXCHLORIDE, BODY FLUID
CHY	XXCHYLOMICRONS
CCK	XXCK,CARDIAC
RCF	XXCLOSTRIDIUM DIFF TOXIN
CH	XXCMV,RUBELLA,HERPES(TORC
RC6	XXCOMPLEMENT 6
RCS	XXCREATINE
CPE	XXCSF PROTEIN ELECT
CY4	XXCYSTICERCOSIS AB, CSF
RCN	XXCYSTINE QUAL URINE
C01	XXCYTOLOGY BODY FLUID
C06	XXCYTOLOGY BRUSHINGS
C08	XXCYTOLOGY HERPES(TZANCK)
C04	XXCYTOLOGY SPUTUM
C05	XXCYTOLOGY WASHINGS
^UR	XXCYTOLOGY, URINE
RDX	XXD-XYLOSE ABSORPTION
DES	XXDESIPRAMINE
NRP	XXDISOPYRAMIDE
DRG	XXDRUGS--OTHER REQUESTS
REN	XXENCAINIDE
EEG	XXENDOGENOUS ERYTHROID GW
FLM	XXFETAL LUNG MATURITY
RPZ	XXFLUOXETINE
FHT	XXFOLATE HCT
FMA	XXFORMIC ACID, URINE
RLS	XXFUROSEMIDE
GAB	XXGABAPENTIN (NEURONTIN)
GTP	XXGLU 3 H(GTT),PREG,UR
G3H	XXGLUCOSE 3H
G4H	XXGLUCOSE 4H
G5H	XXGLUCOSE 5H
G6H	XXGLUCOSE 6H
GPI	XXGLUCOSE PHOS ISOMERASE
G2A	XXGLUCOSE TOL 2H ABB UR
TT1	XXGLUCOSE TOLERANCE 2H
FOB	XXHEMOCCULT-COLON CANCER
OCC	XXHEMOCCULT-COLON CANCER
HEF	XXHEMOGLOBIN F
RO2	XXHEMOGLOBIN O2 AFFINITY
HRL	XXHEP C RNA PCR, QUAL
HRC	XXHEPATITIS C RIBA 3.0
HDM	XXHEPATITIS D IGM AB
HEX	XXHEX PHOSPHOLIPID APTT
RHV	XXHOMOVANILLIC ACID
HYP	XXHYPERAL PANEL
IBU	XXIBUPROFEN
IAB	XXIGA SECRETORY
IMI	XXIMIPRAMINE/DESIPRAMINE
IFL	XXINFLUENZA AB TYPE AANDB
FLU	XXINFLUENZAE A AND B AG
HFI	XXINR - HOME FINGERSTICK
IFB	XXINSULIN TOTAL FREE & BN
JAK	XXJAK2 MUTATION ANALYSIS
RKC	XXKAOLIN CLOTTING TIME
SKE	XXKETONES, SERUM
UKE	XXKETONES,URINE
LAA	XXLACTATE ARTERIAL
LAW	XXLACTATE WHOLE BLOOD
LAP	XXLEUK ALK PHOS
RL3	XXLYMPH AG & MIT PROLIFL
LUD	XXMAPROTILINE
MAL	XXME ALCOHOL PANEL
MAM	XXME AMPHETAMINE CONFIRM
BOB	XXME BLOOD ORGANIC BASE
MCM	XXME CARBON MONOXIDE
MCO	XXME COCAINE CONFIRM
MCR	XXME CREATININE, VIT.FL.
MDE	XXME DEMOGRAPHICS
MGL	XXME GLUCOSE, VIT. FL
ME	XXME MED EXAMNR DRUG SCR
MMS	XXME MISCELLANEOUS
MOP	XXME OPIATE CONFIRM
MRW	XXME REFERRED WORK
MSE	XXME SEDATIVE SCREEN
MUN	XXME UREA, VIT.FL.
UOB	XXME URINE ORGANIC BASE
MVF	XXME VITREOUS FLUID MASTE
MVL	XXME VITREOUS LYTES
MSD	XXMESORIDAZINE (SERENTIL)
REL	XXMETHSUXIMIDE
MHA	XXMETHYLHIPPURIC ACID
RME	XXMEXILETINE
ZBF	XXMISC BODY FLUID
FRE	XXMOLEC FRAGILE XE
FMD	XXMOLEC FSHMD
BCR	XXMOLECULAR BCR/ABL QUAL
MCZ	XXMORICIZINE (ETHMOZINE)
MYO	XXMYOCARDIAL AB
NPT	XXNEOPTERIN
RPL	XXNIFEDIPINE
NTG	XXNITRATE, BLOOD
TPN	XXNUTRITION (BASE/MON)
ENH	XXNUTRITION-ENTERAL /THUR
ENB	XXNUTRITION-ENTERAL(B/M)
TPD	XXNUTRITION-TPN D2,3,4
OH2	XXOCC HEALTH PANEL 2
PP3	XXOR NA,K,HCT
OST	XXOSTEOCALCIN
IOX	XXOXYCODONE URINE CONFIRM
PCN	XXPANA ANTIBODY
RBN	XXPCB(POLYCHLORINATE BIPH
PEP	XXPEDS ENDOCRIN PANEL
PHS	XXPH SCALP
PHN	XXPHENCYCLIDINE SCREEN
PCP	XXPHENCYCLIDINE, SERUM
PLZ	XXPHENELZINE
PTZ	XXPHENOTHIAZINE SCREEN
PP7	XXPOC SEVEN PLUS PROFILE
PP6	XXPOC SIX PLUS PROFILE
RPA	XXPOLY RIBOSE PHOS AB
BK	XXPOTASSIUM, BODY FLUID
PI1	XXPREG HYPERTENS PROF
RBZ	XXPROPAFENONE(RHYTHMAL)
PPX	XXPROPOXYPHENE (DARVON)
PRX	XXPROPOXYPHENE SCREEN
FPS	XXPSA FREE, % FREE
PSF	XXPSA,FREE AND TOTAL
PCX	XXPYRIDINIUM COLLAGEN XLI
DCR	XXREFLEX COMP. DRUG SCR.
SCB	XXSECOBARBITAL
GAS	XXSETTINGS - BLOOD GASES
BNA	XXSODIUM, BODY FLUID
SOT	XXSOTALOL
SUC	XXSUCROSE HEMOLYSIS
T3	XXT3 UPTAKE
TAA	XXTEICHOIC ACID ANTIBODES
TSB	XXTESTOSTERONE, BIOAVAIL
C07	XXTOLOGY NIPPLE DISCHARGE
THD	XXTOTAL HYDROXYPROLINE
TPS	XXTOTAL PSA/REFLEX FREE
T4	XXTOTAL T4
XTP	XXTRIAL3HOUR, PRENATAL
GT2	XXURINE GLU FOR TOLERANCE
UPI	XXUROPORPHYRINOGEN I-SYN
UPG	XXUROPORPHYRINOGEN, ERYTH
VCS	XXVANCOMYCIN, CSF
RVP	XXVERAPAMIL
PEI	XXXB PERTUSSIS AB PANEL
CTD	XXXCYTOMEG DNA BY PCR
WBG	XXXPOC GLUCOSE BY METER
RBG	XXXREPTILASE R-TIME
RAJ	XXYERSINIA ENTERO AB
UP	XXZU (OHSU) PORPHOBILINOG
ZUA	XXZU AFB SENSITIVITIES,RE
IAO	XXZU CSF IGA
AMG	XXZU CSF IGA,IGM,IGG QUAN
IGO	XXZU CSF IGG
ISR	XXZU IGG SYNTH RATE
IGB	XXZU IGG, BODY FLUID
IMB	XXZU IGM, BODY FLUID
BFR	XXZU RA FACTOR, B.FLUID
MIB	XXZU SUSC ANAER BACTER M
P73	YEAST GENERAL WKUP
YSU	YEAST SUSCEPTIBILITY
YHA	YELLOW HORNET IGE ALLRGN
YJA	YELLOW JACKET IGE ALLRGN
YER	YERSINIA CULTURE
RYR	YERSINIA PSEUDOTUBERCULOS
ZT	Z TEST
ZN	ZINC - PLASMA
RZP	ZINC PROTOPORPHRIN
RZU	ZINC URINE
ZNE	ZONISAMIDE
UB1	ZU (OHSU) B12
UD1	ZU (OHSU) DRUG SCREEN P1
UD2	ZU (OHSU) DRUG SCREEN P2
UD3	ZU (OHSU) DRUG SCREEN P3
UD4	ZU (OHSU) DRUG SCREEN P4
UD5	ZU (OHSU) DRUG SCREEN P5
UB2	ZU (OHSU) FOLATE
CRF	ZU CRYOFIBRINOGEN
CYG	ZU CRYOGLOBULIN
IMO	ZU CSF IGM
EXC	ZU EXUDATE CULTURE, QUANT
GCG	ZU GC/GENITAL CULTURE
HAT	ZU HEP A AB, TOTAL
HBN	ZU HEP B CORE AB, TOTAL
HCA	ZU HEP C ANTIBODY
UAF	ZU PRENATAL SCRN AMNIO
STS	ZU STERILITY CULTURE SENS
T4O	ZU TOTAL T4 (OHSU ONLY)
PTO	ZU(OHSU)PARATHYROID HOR
AI	ZY ANTIBODY IDENT
MIS	ZY MISCELLANEOUS
ACP	ZZ ACID PHOSPHATASE
AF1	ZZ AFB PRELIM 1
GBM	ZZ ANTI-GLOM MEMB, QUAL
CDT	ZZ CHLAMYDIA DIRECT TEST
CFH	ZZ CHROMO STUDIES FLUORES
FI1	ZZ FUNGUS ISOLATE PRELIM
FU1	ZZ FUNGUS PRELIMINARY 1
IRG	ZZ GENETIC COUNSELING
AL5	ZZ IBT ALLERGENS
XAP	ZZ MIXING STUDY, APTT
MPT	ZZ MOLEC PAT TESTING
RE0	ZZ MYCOPLASMA IGM BY EIA
PWF	ZZ PRADER-WILLI FISH
SPD	ZZ SPORDI TEST
PTX	ZZ TIME
DU1	ZZ URINE DRUG SCR #1
DU2	ZZ URINE DRUG SCREEN #2
