Location	Type	Department?	Category
Ambulatory_Surgery_Center:NA	Ambulatory_Surgery_Center	NA	Ambulatory_Surgery
Ambulatory_Surgery_Center:Surgery_Ambulatory	Ambulatory_Surgery_Center	Surgery_Ambulatory	Ambulatory_Surgery
Ambulatory_Surgery_Center	Ambulatory_Surgery_Center		Ambulatory_Surgery
Home_Care_Services:Allergy_Asthma_and_Immunology	Home_Care_Services	Allergy_Asthma_and_Immunology	Home_Care_Services
Home_Care_Services:Cardiology	Home_Care_Services	Cardiology	Home_Care_Services
Home_Care_Services:Continuing_Care	Home_Care_Services	Continuing_Care	Home_Care_Services
Home_Care_Services:Diabetes_Services	Home_Care_Services	Diabetes_Services	Home_Care_Services
Home_Care_Services:Expanded_Care	Home_Care_Services	Expanded_Care	Home_Care_Services
Home_Care_Services:Family_Practice	Home_Care_Services	Family_Practice	Home_Care_Services
Home_Care_Services:Genetics	Home_Care_Services	Genetics	Home_Care_Services
Home_Care_Services:Geriatric_Medicine	Home_Care_Services	Geriatric_Medicine	Home_Care_Services
Home_Care_Services:Home_Health_Care	Home_Care_Services	Home_Health_Care	Home_Care_Services
Home_Care_Services:Hospice_Care	Home_Care_Services	Hospice_Care	Home_Care_Services
Home_Care_Services:Immunology	Home_Care_Services	Immunology	Home_Care_Services
Home_Care_Services:Infectious_Diseases	Home_Care_Services	Infectious_Diseases	Home_Care_Services
Home_Care_Services:Internal_Medicine	Home_Care_Services	Internal_Medicine	Home_Care_Services
Home_Care_Services:Laboratory	Home_Care_Services	Laboratory	Home_Care_Services
Home_Care_Services:Minor_Injury_Clinic	Home_Care_Services	Minor_Injury_Clinic	Home_Care_Services
Home_Care_Services:NA	Home_Care_Services	NA	Home_Care_Services
Home_Care_Services:Nephrology	Home_Care_Services	Nephrology	Home_Care_Services
Home_Care_Services:Neurology	Home_Care_Services	Neurology	Home_Care_Services
Home_Care_Services:Neurosurgery	Home_Care_Services	Neurosurgery	Home_Care_Services
Home_Care_Services:Nurse_Treatment_Room	Home_Care_Services	Nurse_Treatment_Room	Home_Care_Services
Home_Care_Services:Obstetrics_Gynecology	Home_Care_Services	Obstetrics_Gynecology	Home_Care_Services
Home_Care_Services:Occupational_Medicine	Home_Care_Services	Occupational_Medicine	Home_Care_Services
Home_Care_Services:Oncology	Home_Care_Services	Oncology	Home_Care_Services
Home_Care_Services:Orthopedic_Surgery	Home_Care_Services	Orthopedic_Surgery	Home_Care_Services
Home_Care_Services:Otolaryngology	Home_Care_Services	Otolaryngology	Home_Care_Services
Home_Care_Services:Palliative_Care	Home_Care_Services	Palliative_Care	Home_Care_Services
Home_Care_Services:Palliative_Care_Home	Home_Care_Services	Palliative_Care_Home	Home_Care_Services
Home_Care_Services:Pediatrics	Home_Care_Services	Pediatrics	Home_Care_Services
Home_Care_Services:Physical_Medicine	Home_Care_Services	Physical_Medicine	Home_Care_Services
Home_Care_Services:Physical_Therapy	Home_Care_Services	Physical_Therapy	Home_Care_Services
Home_Care_Services:Pulmonary_Diseases	Home_Care_Services	Pulmonary_Diseases	Home_Care_Services
Home_Care_Services:Radiology	Home_Care_Services	Radiology	Home_Care_Services
Home_Care_Services:Temporal_Mandibular_Disorder	Home_Care_Services	Temporal_Mandibular_Disorder	Home_Care_Services
Home_Care_Services:Urgent_Care	Home_Care_Services	Urgent_Care	Home_Care_Services
Home_Care_Services:Urology	Home_Care_Services	Urology	Home_Care_Services
Home_Care_Services	Home_Care_Services		Home_Care_Services
Hospice:NA	Hospice	NA	Hospice
Hospice	Hospice		Hospice
Hospital_Ambulatory_Surgery:Ambulatory_Care_Unit	Hospital_Ambulatory_Surgery	Ambulatory_Care_Unit	Ambulatory_Surgery
Hospital_Ambulatory_Surgery:Cardiology	Hospital_Ambulatory_Surgery	Cardiology	Ambulatory_Surgery
Hospital_Ambulatory_Surgery:Critical_Care_Medicine	Hospital_Ambulatory_Surgery	Critical_Care_Medicine	Ambulatory_Surgery
Hospital_Ambulatory_Surgery:Emergency_Medicine	Hospital_Ambulatory_Surgery	Emergency_Medicine	Ambulatory_Surgery
Hospital_Ambulatory_Surgery:Labor_&_Delivery	Hospital_Ambulatory_Surgery	Labor_&_Delivery	Ambulatory_Surgery
Hospital_Ambulatory_Surgery:Medical_Ambulatory_Care	Hospital_Ambulatory_Surgery	Medical_Ambulatory_Care	Ambulatory_Surgery
Hospital_Ambulatory_Surgery:NA	Hospital_Ambulatory_Surgery	NA	Ambulatory_Surgery
Hospital_Ambulatory_Surgery:Neonatology	Hospital_Ambulatory_Surgery	Neonatology	Ambulatory_Surgery
Hospital_Ambulatory_Surgery:Oncology	Hospital_Ambulatory_Surgery	Oncology	Ambulatory_Surgery
Hospital_Ambulatory_Surgery:Surgery_Cardiovascular	Hospital_Ambulatory_Surgery	Surgery_Cardiovascular	Ambulatory_Surgery
Hospital_Ambulatory_Surgery:Surgery_General	Hospital_Ambulatory_Surgery	Surgery_General	Ambulatory_Surgery
Hospital_Ambulatory_Surgery	Hospital_Ambulatory_Surgery		Ambulatory_Surgery
Hospital_Chemical_Dependency:Cardiology	Hospital_Chemical_Dependency	Cardiology	Mental_Health
Hospital_Chemical_Dependency:Critical_Care_Medicine	Hospital_Chemical_Dependency	Critical_Care_Medicine	Mental_Health
Hospital_Chemical_Dependency:Emergency_Medicine	Hospital_Chemical_Dependency	Emergency_Medicine	Mental_Health
Hospital_Chemical_Dependency:NA	Hospital_Chemical_Dependency	NA	Mental_Health
Hospital_Chemical_Dependency:Oncology	Hospital_Chemical_Dependency	Oncology	Mental_Health
Hospital_Chemical_Dependency	Hospital_Chemical_Dependency		Mental_Health
Hospital_Emergency_Department:Emergency_Medicine	Hospital_Emergency_Department	Emergency_Medicine	Emergency_Medicine
Hospital_Emergency_Department:NA	Hospital_Emergency_Department	NA	Emergency_Medicine
Hospital_Emergency_Department	Hospital_Emergency_Department		Emergency_Medicine
Hospital_Inpatient_Admission:Ambulatory_Care_Unit	Hospital_Inpatient_Admission	Ambulatory_Care_Unit	Inpatient
Hospital_Inpatient_Admission:Cardiology	Hospital_Inpatient_Admission	Cardiology	Inpatient
Hospital_Inpatient_Admission:Critical_Care_Medicine	Hospital_Inpatient_Admission	Critical_Care_Medicine	Critical_Care
Hospital_Inpatient_Admission:Emergency_Medicine	Hospital_Inpatient_Admission	Emergency_Medicine	Inpatient
Hospital_Inpatient_Admission:Labor_&_Delivery	Hospital_Inpatient_Admission	Labor_&_Delivery	Inpatient_LD
Hospital_Inpatient_Admission:Medical_Ambulatory_Care	Hospital_Inpatient_Admission	Medical_Ambulatory_Care	Inpatient
Hospital_Inpatient_Admission:NA	Hospital_Inpatient_Admission	NA	Inpatient
Hospital_Inpatient_Admission:Neonatology	Hospital_Inpatient_Admission	Neonatology	Inpatient
Hospital_Inpatient_Admission:Oncology	Hospital_Inpatient_Admission	Oncology	Inpatient_Onc
Hospital_Inpatient_Admission:Surgery_General	Hospital_Inpatient_Admission	Surgery_General	Inpatient_Surgery
Hospital_Inpatient_Admission	Hospital_Inpatient_Admission		Inpatient
Hospital_Mental_Health:Cardiology	Hospital_Mental_Health	Cardiology	Mental_Health
Hospital_Mental_Health:Critical_Care_Medicine	Hospital_Mental_Health	Critical_Care_Medicine	Mental_Health
Hospital_Mental_Health:Emergency_Medicine	Hospital_Mental_Health	Emergency_Medicine	Mental_Health
Hospital_Mental_Health:NA	Hospital_Mental_Health	NA	Mental_Health
Hospital_Mental_Health:Oncology	Hospital_Mental_Health	Oncology	Mental_Health
Hospital_Mental_Health:Surgery_General	Hospital_Mental_Health	Surgery_General	Mental_Health
Hospital_Mental_Health	Hospital_Mental_Health		Mental_Health
Hospital_New_Born:Labor_&_Delivery	Hospital_New_Born	Labor_&_Delivery	Inpatient_LD
Hospital_New_Born:NA	Hospital_New_Born	NA	Inpatient_LD
Hospital_New_Born:Neonatology	Hospital_New_Born	Neonatology	Inpatient_LD
Hospital_New_Born	Hospital_New_Born		Inpatient_LD
Hospital_Observation:Ambulatory_Care_Unit	Hospital_Observation	Ambulatory_Care_Unit	Observation
Hospital_Observation:Cardiology	Hospital_Observation	Cardiology	Observation
Hospital_Observation:Critical_Care_Medicine	Hospital_Observation	Critical_Care_Medicine	Observation
Hospital_Observation:Emergency_Medicine	Hospital_Observation	Emergency_Medicine	Observation
Hospital_Observation:Labor_&_Delivery	Hospital_Observation	Labor_&_Delivery	Observation
Hospital_Observation:Medical_Ambulatory_Care	Hospital_Observation	Medical_Ambulatory_Care	Observation
Hospital_Observation:NA	Hospital_Observation	NA	Observation
Hospital_Observation:Neonatology	Hospital_Observation	Neonatology	Observation
Hospital_Observation:Nuclear_Medicine	Hospital_Observation	Nuclear_Medicine	Observation
Hospital_Observation:Oncology	Hospital_Observation	Oncology	Observation
Hospital_Observation:Surgery_General	Hospital_Observation	Surgery_General	Observation
Hospital_Observation	Hospital_Observation		Observation
Hospital_Other:Addiction_Medicine	Hospital_Other	Addiction_Medicine	Mental_Health
Hospital_Other:Ambulatory_Care_Unit	Hospital_Other	Ambulatory_Care_Unit	Outpatient
Hospital_Other:Cardiology	Hospital_Other	Cardiology	Other
Hospital_Other:Catscan	Hospital_Other	Catscan	Other
Hospital_Other:Critical_Care_Medicine	Hospital_Other	Critical_Care_Medicine	Other
Hospital_Other:Emergency_Medicine	Hospital_Other	Emergency_Medicine	Emergency_Medicine
Hospital_Other:Labor_&_Delivery	Hospital_Other	Labor_&_Delivery	Other
Hospital_Other:Magnet_Resonance_Img	Hospital_Other	Magnet_Resonance_Img	Other
Hospital_Other:Mammography	Hospital_Other	Mammography	Other
Hospital_Other:Medical_Ambulatory_Care	Hospital_Other	Medical_Ambulatory_Care	Outpatient
Hospital_Other:NA	Hospital_Other	NA	Other
Hospital_Other:Neonatology	Hospital_Other	Neonatology	Other
Hospital_Other:Nuclear_Medicine	Hospital_Other	Nuclear_Medicine	Other
Hospital_Other:Oncology	Hospital_Other	Oncology	Other
Hospital_Other:Radiology	Hospital_Other	Radiology	Other
Hospital_Other:Surgery_General	Hospital_Other	Surgery_General	Other
Hospital_Other:Ultrasound	Hospital_Other	Ultrasound	Other
Hospital_Other	Hospital_Other		Other
Intermediate_Care_Facility:NA	Intermediate_Care_Facility	NA	Intermediate_Care
Intermediate_Care_Facility	Intermediate_Care_Facility		Intermediate_Care
Outpatient_Abstract:Addiction_Medicine	Outpatient_Abstract	Addiction_Medicine	Outpatient
Outpatient_Abstract:Allergy_Asthma_and_Immunology	Outpatient_Abstract	Allergy_Asthma_and_Immunology	Outpatient
Outpatient_Abstract:Alternative_Medicine	Outpatient_Abstract	Alternative_Medicine	Outpatient
Outpatient_Abstract:Anesthesiology	Outpatient_Abstract	Anesthesiology	Outpatient
Outpatient_Abstract:Anti-Coagulation_Services	Outpatient_Abstract	Anti-Coagulation_Services	Outpatient
Outpatient_Abstract:Audiology	Outpatient_Abstract	Audiology	Outpatient
Outpatient_Abstract:Behavioral_Health	Outpatient_Abstract	Behavioral_Health	Outpatient
Outpatient_Abstract:Call_Center	Outpatient_Abstract	Call_Center	Outpatient
Outpatient_Abstract:Cardiology	Outpatient_Abstract	Cardiology	Outpatient
Outpatient_Abstract:Case_Management	Outpatient_Abstract	Case_Management	Outpatient
Outpatient_Abstract:Continuing_Care	Outpatient_Abstract	Continuing_Care	Outpatient
Outpatient_Abstract:Dermatology	Outpatient_Abstract	Dermatology	Outpatient
Outpatient_Abstract:Durable_Medical_Equipment	Outpatient_Abstract	Durable_Medical_Equipment	Outpatient
Outpatient_Abstract:Emergency_Medicine	Outpatient_Abstract	Emergency_Medicine	Outpatient
Outpatient_Abstract:Emergicenter	Outpatient_Abstract	Emergicenter	Outpatient
Outpatient_Abstract:Endocrinology_Diabetes/Metabolism	Outpatient_Abstract	Endocrinology_Diabetes/Metabolism	Outpatient
Outpatient_Abstract:Endoscopy	Outpatient_Abstract	Endoscopy	Outpatient
Outpatient_Abstract:Expanded_Care	Outpatient_Abstract	Expanded_Care	Outpatient
Outpatient_Abstract:Family_Practice	Outpatient_Abstract	Family_Practice	Outpatient
Outpatient_Abstract:Foot_Care	Outpatient_Abstract	Foot_Care	Outpatient
Outpatient_Abstract:Fracture_Clinic	Outpatient_Abstract	Fracture_Clinic	Outpatient
Outpatient_Abstract:Gastroenterology	Outpatient_Abstract	Gastroenterology	Outpatient
Outpatient_Abstract:Genetics	Outpatient_Abstract	Genetics	Outpatient
Outpatient_Abstract:Geriatric_Medicine	Outpatient_Abstract	Geriatric_Medicine	Outpatient
Outpatient_Abstract:Health_Education	Outpatient_Abstract	Health_Education	Outpatient
Outpatient_Abstract:Health_Systems	Outpatient_Abstract	Health_Systems	Outpatient
Outpatient_Abstract:Home_Health_Care	Outpatient_Abstract	Home_Health_Care	Outpatient
Outpatient_Abstract:Hospice_Care	Outpatient_Abstract	Hospice_Care	Outpatient
Outpatient_Abstract:Immunology	Outpatient_Abstract	Immunology	Outpatient
Outpatient_Abstract:Infectious_Diseases	Outpatient_Abstract	Infectious_Diseases	Outpatient
Outpatient_Abstract:Infusion_Therapy	Outpatient_Abstract	Infusion_Therapy	Outpatient
Outpatient_Abstract:Internal_Medicine	Outpatient_Abstract	Internal_Medicine	Outpatient
Outpatient_Abstract:INTERVENTIONAL_RADIOLOGY	Outpatient_Abstract	INTERVENTIONAL_RADIOLOGY	Outpatient
Outpatient_Abstract:K.P._Recovery_Resources	Outpatient_Abstract	K.P._Recovery_Resources	Outpatient
Outpatient_Abstract:Labor_&_Delivery	Outpatient_Abstract	Labor_&_Delivery	Outpatient
Outpatient_Abstract:Laboratory	Outpatient_Abstract	Laboratory	Outpatient
Outpatient_Abstract:Magnet_Resonance_Img	Outpatient_Abstract	Magnet_Resonance_Img	Outpatient
Outpatient_Abstract:Medical_Records	Outpatient_Abstract	Medical_Records	Outpatient
Outpatient_Abstract:Mental_Health_IOP	Outpatient_Abstract	Mental_Health_IOP	Outpatient
Outpatient_Abstract:Minor_Injury_Clinic	Outpatient_Abstract	Minor_Injury_Clinic	Outpatient
Outpatient_Abstract:Mohs_Surgery_Services	Outpatient_Abstract	Mohs_Surgery_Services	Outpatient
Outpatient_Abstract:NA	Outpatient_Abstract	NA	Outpatient
Outpatient_Abstract:Neonatology	Outpatient_Abstract	Neonatology	Outpatient
Outpatient_Abstract:Nephrology	Outpatient_Abstract	Nephrology	Outpatient
Outpatient_Abstract:Neurology	Outpatient_Abstract	Neurology	Outpatient
Outpatient_Abstract:Neurosurgery	Outpatient_Abstract	Neurosurgery	Outpatient
Outpatient_Abstract:Not_Elsewhere_Classified	Outpatient_Abstract	Not_Elsewhere_Classified	Outpatient
Outpatient_Abstract:Nuclear_Medicine	Outpatient_Abstract	Nuclear_Medicine	Outpatient
Outpatient_Abstract:Nurse_Treatment_Room	Outpatient_Abstract	Nurse_Treatment_Room	Outpatient
Outpatient_Abstract:Nurse_Visit	Outpatient_Abstract	Nurse_Visit	Outpatient
Outpatient_Abstract:Nutritional_Services	Outpatient_Abstract	Nutritional_Services	Outpatient
Outpatient_Abstract:Obstetrics_Gynecology	Outpatient_Abstract	Obstetrics_Gynecology	Outpatient
Outpatient_Abstract:Occupational_Medicine	Outpatient_Abstract	Occupational_Medicine	Outpatient
Outpatient_Abstract:Occupational_Therapy	Outpatient_Abstract	Occupational_Therapy	Outpatient
Outpatient_Abstract:Oncology	Outpatient_Abstract	Oncology	Outpatient
Outpatient_Abstract:Ophthalmology	Outpatient_Abstract	Ophthalmology	Outpatient
Outpatient_Abstract:Optometry	Outpatient_Abstract	Optometry	Outpatient
Outpatient_Abstract:Orthopedic_Surgery	Outpatient_Abstract	Orthopedic_Surgery	Outpatient
Outpatient_Abstract:Otolaryngology	Outpatient_Abstract	Otolaryngology	Outpatient
Outpatient_Abstract:Pain_Management	Outpatient_Abstract	Pain_Management	Outpatient
Outpatient_Abstract:Palliative_Care	Outpatient_Abstract	Palliative_Care	Outpatient
Outpatient_Abstract:Palliative_Care_Home	Outpatient_Abstract	Palliative_Care_Home	Outpatient
Outpatient_Abstract:Pediatric_Cardiology	Outpatient_Abstract	Pediatric_Cardiology	Outpatient
Outpatient_Abstract:Pediatric_Endocrinology	Outpatient_Abstract	Pediatric_Endocrinology	Outpatient
Outpatient_Abstract:Pediatric_Gastroenterology	Outpatient_Abstract	Pediatric_Gastroenterology	Outpatient
Outpatient_Abstract:Pediatric_Hematology/Oncology	Outpatient_Abstract	Pediatric_Hematology/Oncology	Outpatient
Outpatient_Abstract:Pediatric_Infectious_Disease	Outpatient_Abstract	Pediatric_Infectious_Disease	Outpatient
Outpatient_Abstract:Pediatric_Nephrology	Outpatient_Abstract	Pediatric_Nephrology	Outpatient
Outpatient_Abstract:Pediatrics	Outpatient_Abstract	Pediatrics	Outpatient
Outpatient_Abstract:Perinatology	Outpatient_Abstract	Perinatology	Outpatient
Outpatient_Abstract:Pharmacy	Outpatient_Abstract	Pharmacy	Outpatient
Outpatient_Abstract:Physical_Medicine	Outpatient_Abstract	Physical_Medicine	Outpatient
Outpatient_Abstract:Physical_Therapy	Outpatient_Abstract	Physical_Therapy	Outpatient
Outpatient_Abstract:Plastic_Surgery	Outpatient_Abstract	Plastic_Surgery	Outpatient
Outpatient_Abstract:Podiatry	Outpatient_Abstract	Podiatry	Outpatient
Outpatient_Abstract:Population_Care_Management	Outpatient_Abstract	Population_Care_Management	Outpatient
Outpatient_Abstract:Pre-operative_Medicine	Outpatient_Abstract	Pre-operative_Medicine	Outpatient
Outpatient_Abstract:Primary_Care	Outpatient_Abstract	Primary_Care	Outpatient
Outpatient_Abstract:Psychiatry	Outpatient_Abstract	Psychiatry	Outpatient
Outpatient_Abstract:Psychiatry_Geriatric	Outpatient_Abstract	Psychiatry_Geriatric	Outpatient
Outpatient_Abstract:Pulmonary_Diseases	Outpatient_Abstract	Pulmonary_Diseases	Outpatient
Outpatient_Abstract:Pulmonary_Funct_Lab	Outpatient_Abstract	Pulmonary_Funct_Lab	Outpatient
Outpatient_Abstract:Radiation_Oncology	Outpatient_Abstract	Radiation_Oncology	Outpatient
Outpatient_Abstract:Radiology	Outpatient_Abstract	Radiology	Outpatient
Outpatient_Abstract:Research_Medicine	Outpatient_Abstract	Research_Medicine	Outpatient
Outpatient_Abstract:Respiratory_Case_Management	Outpatient_Abstract	Respiratory_Case_Management	Outpatient
Outpatient_Abstract:Respiratory_Therapy	Outpatient_Abstract	Respiratory_Therapy	Outpatient
Outpatient_Abstract:Rheumatology	Outpatient_Abstract	Rheumatology	Outpatient
Outpatient_Abstract:Sleep_Clinic	Outpatient_Abstract	Sleep_Clinic	Outpatient
Outpatient_Abstract:Sleep_Medicine	Outpatient_Abstract	Sleep_Medicine	Outpatient
Outpatient_Abstract:Social_Services	Outpatient_Abstract	Social_Services	Outpatient
Outpatient_Abstract:Surgery_Ambulatory	Outpatient_Abstract	Surgery_Ambulatory	Outpatient
Outpatient_Abstract:Surgery_Cardiovascular	Outpatient_Abstract	Surgery_Cardiovascular	Outpatient
Outpatient_Abstract:Surgery_General	Outpatient_Abstract	Surgery_General	Outpatient
Outpatient_Abstract:Surgery_Vascular	Outpatient_Abstract	Surgery_Vascular	Outpatient
Outpatient_Abstract:Temporal_Mandibular_Disorder	Outpatient_Abstract	Temporal_Mandibular_Disorder	Outpatient
Outpatient_Abstract:Travel_Medicine	Outpatient_Abstract	Travel_Medicine	Outpatient
Outpatient_Abstract:Tumor_Registry	Outpatient_Abstract	Tumor_Registry	Outpatient
Outpatient_Abstract:Urgent_Care	Outpatient_Abstract	Urgent_Care	Outpatient
Outpatient_Abstract:Urology	Outpatient_Abstract	Urology	Outpatient
Outpatient_Abstract:Weight_Management	Outpatient_Abstract	Weight_Management	Outpatient
Outpatient_Abstract:Wound_Care	Outpatient_Abstract	Wound_Care	Outpatient
Outpatient_Abstract	Outpatient_Abstract		Outpatient
Outpatient_Chart_Review:Addiction_Medicine	Outpatient_Chart_Review	Addiction_Medicine	Outpatient_Review
Outpatient_Chart_Review:Administration	Outpatient_Chart_Review	Administration	Outpatient_Review
Outpatient_Chart_Review:Allergy_Asthma_and_Immunology	Outpatient_Chart_Review	Allergy_Asthma_and_Immunology	Outpatient_Review
Outpatient_Chart_Review:Ambulatory_Surgery	Outpatient_Chart_Review	Ambulatory_Surgery	Outpatient_Review
Outpatient_Chart_Review:Anesthesiology	Outpatient_Chart_Review	Anesthesiology	Outpatient_Review
Outpatient_Chart_Review:Anti-Coagulation_Services	Outpatient_Chart_Review	Anti-Coagulation_Services	Outpatient_Review
Outpatient_Chart_Review:Audiology	Outpatient_Chart_Review	Audiology	Outpatient_Review
Outpatient_Chart_Review:Behavioral_Health	Outpatient_Chart_Review	Behavioral_Health	Outpatient_Review
Outpatient_Chart_Review:Bone_Density	Outpatient_Chart_Review	Bone_Density	Outpatient_Review
Outpatient_Chart_Review:Call_Center	Outpatient_Chart_Review	Call_Center	Outpatient_Review
Outpatient_Chart_Review:Cardiology	Outpatient_Chart_Review	Cardiology	Outpatient_Review
Outpatient_Chart_Review:Case_Management	Outpatient_Chart_Review	Case_Management	Outpatient_Review
Outpatient_Chart_Review:Catscan	Outpatient_Chart_Review	Catscan	Outpatient_Review
Outpatient_Chart_Review:Continuing_Care	Outpatient_Chart_Review	Continuing_Care	Outpatient_Review
Outpatient_Chart_Review:Critical_Care_Medicine	Outpatient_Chart_Review	Critical_Care_Medicine	Outpatient_Review
Outpatient_Chart_Review:Dentistry	Outpatient_Chart_Review	Dentistry	Outpatient_Review
Outpatient_Chart_Review:Dermatology	Outpatient_Chart_Review	Dermatology	Outpatient_Review
Outpatient_Chart_Review:Diabetes_Services	Outpatient_Chart_Review	Diabetes_Services	Outpatient_Review
Outpatient_Chart_Review:Durable_Medical_Equipment	Outpatient_Chart_Review	Durable_Medical_Equipment	Outpatient_Review
Outpatient_Chart_Review:EEG	Outpatient_Chart_Review	EEG	Outpatient_Review
Outpatient_Chart_Review:Emergency_Medicine	Outpatient_Chart_Review	Emergency_Medicine	Outpatient_Review
Outpatient_Chart_Review:Emergicenter	Outpatient_Chart_Review	Emergicenter	Outpatient_Review
Outpatient_Chart_Review:Employee_Health	Outpatient_Chart_Review	Employee_Health	Outpatient_Review
Outpatient_Chart_Review:Endocrinology_Diabetes/Metabolism	Outpatient_Chart_Review	Endocrinology_Diabetes/Metabolism	Outpatient_Review
Outpatient_Chart_Review:Endoscopy	Outpatient_Chart_Review	Endoscopy	Outpatient_Review
Outpatient_Chart_Review:Expanded_Care	Outpatient_Chart_Review	Expanded_Care	Outpatient_Review
Outpatient_Chart_Review:Eye_Care_Imaging	Outpatient_Chart_Review	Eye_Care_Imaging	Outpatient_Review
Outpatient_Chart_Review:Family_Practice	Outpatient_Chart_Review	Family_Practice	Outpatient_Review
Outpatient_Chart_Review:Foot_Care	Outpatient_Chart_Review	Foot_Care	Outpatient_Review
Outpatient_Chart_Review:Fracture_Clinic	Outpatient_Chart_Review	Fracture_Clinic	Outpatient_Review
Outpatient_Chart_Review:Gastroenterology	Outpatient_Chart_Review	Gastroenterology	Outpatient_Review
Outpatient_Chart_Review:Genetics	Outpatient_Chart_Review	Genetics	Outpatient_Review
Outpatient_Chart_Review:Geriatric_Medicine	Outpatient_Chart_Review	Geriatric_Medicine	Outpatient_Review
Outpatient_Chart_Review:Gynecology_Urology	Outpatient_Chart_Review	Gynecology_Urology	Outpatient_Review
Outpatient_Chart_Review:Health_Education	Outpatient_Chart_Review	Health_Education	Outpatient_Review
Outpatient_Chart_Review:Health_Systems	Outpatient_Chart_Review	Health_Systems	Outpatient_Review
Outpatient_Chart_Review:Home_Health_Care	Outpatient_Chart_Review	Home_Health_Care	Outpatient_Review
Outpatient_Chart_Review:Hospice_Care	Outpatient_Chart_Review	Hospice_Care	Outpatient_Review
Outpatient_Chart_Review:Immunology	Outpatient_Chart_Review	Immunology	Outpatient_Review
Outpatient_Chart_Review:Infectious_Diseases	Outpatient_Chart_Review	Infectious_Diseases	Outpatient_Review
Outpatient_Chart_Review:Infusion_Therapy	Outpatient_Chart_Review	Infusion_Therapy	Outpatient_Review
Outpatient_Chart_Review:Inpatient	Outpatient_Chart_Review	Inpatient	Outpatient_Review
Outpatient_Chart_Review:Internal_Medicine	Outpatient_Chart_Review	Internal_Medicine	Outpatient_Review
Outpatient_Chart_Review:INTERVENTIONAL_RADIOLOGY	Outpatient_Chart_Review	INTERVENTIONAL_RADIOLOGY	Outpatient_Review
Outpatient_Chart_Review:K.P._Recovery_Resources	Outpatient_Chart_Review	K.P._Recovery_Resources	Outpatient_Review
Outpatient_Chart_Review:Labor_&_Delivery	Outpatient_Chart_Review	Labor_&_Delivery	Outpatient_Review
Outpatient_Chart_Review:Laboratory	Outpatient_Chart_Review	Laboratory	Outpatient_Review
Outpatient_Chart_Review:Magnet_Resonance_Img	Outpatient_Chart_Review	Magnet_Resonance_Img	Outpatient_Review
Outpatient_Chart_Review:Mammography	Outpatient_Chart_Review	Mammography	Outpatient_Review
Outpatient_Chart_Review:Medical_Ambulatory_Care	Outpatient_Chart_Review	Medical_Ambulatory_Care	Outpatient_Review
Outpatient_Chart_Review:Medical_Records	Outpatient_Chart_Review	Medical_Records	Outpatient_Review
Outpatient_Chart_Review:Mental_Health_IOP	Outpatient_Chart_Review	Mental_Health_IOP	Outpatient_Review
Outpatient_Chart_Review:Minor_Injury_Clinic	Outpatient_Chart_Review	Minor_Injury_Clinic	Outpatient_Review
Outpatient_Chart_Review:Mohs_Surgery_Services	Outpatient_Chart_Review	Mohs_Surgery_Services	Outpatient_Review
Outpatient_Chart_Review:NA	Outpatient_Chart_Review	NA	Outpatient_Review
Outpatient_Chart_Review:Nephrology	Outpatient_Chart_Review	Nephrology	Outpatient_Review
Outpatient_Chart_Review:Neurology	Outpatient_Chart_Review	Neurology	Outpatient_Review
Outpatient_Chart_Review:Neurosurgery	Outpatient_Chart_Review	Neurosurgery	Outpatient_Review
Outpatient_Chart_Review:Not_Elsewhere_Classified	Outpatient_Chart_Review	Not_Elsewhere_Classified	Outpatient_Review
Outpatient_Chart_Review:Nuclear_Medicine	Outpatient_Chart_Review	Nuclear_Medicine	Outpatient_Review
Outpatient_Chart_Review:Nurse_Treatment_Room	Outpatient_Chart_Review	Nurse_Treatment_Room	Outpatient_Review
Outpatient_Chart_Review:Nurse_Visit	Outpatient_Chart_Review	Nurse_Visit	Outpatient_Review
Outpatient_Chart_Review:Nutritional_Services	Outpatient_Chart_Review	Nutritional_Services	Outpatient_Review
Outpatient_Chart_Review:Obstetrics_Gynecology	Outpatient_Chart_Review	Obstetrics_Gynecology	Outpatient_Review
Outpatient_Chart_Review:Occupational_Medicine	Outpatient_Chart_Review	Occupational_Medicine	Outpatient_Review
Outpatient_Chart_Review:Occupational_Therapy	Outpatient_Chart_Review	Occupational_Therapy	Outpatient_Review
Outpatient_Chart_Review:Oncology	Outpatient_Chart_Review	Oncology	Outpatient_Review
Outpatient_Chart_Review:Ophthalmology	Outpatient_Chart_Review	Ophthalmology	Outpatient_Review
Outpatient_Chart_Review:Optometry	Outpatient_Chart_Review	Optometry	Outpatient_Review
Outpatient_Chart_Review:Orthopedic_Surgery	Outpatient_Chart_Review	Orthopedic_Surgery	Outpatient_Review
Outpatient_Chart_Review:Otolaryngology	Outpatient_Chart_Review	Otolaryngology	Outpatient_Review
Outpatient_Chart_Review:Pain_Management	Outpatient_Chart_Review	Pain_Management	Outpatient_Review
Outpatient_Chart_Review:Palliative_Care	Outpatient_Chart_Review	Palliative_Care	Outpatient_Review
Outpatient_Chart_Review:Palliative_Care_Home	Outpatient_Chart_Review	Palliative_Care_Home	Outpatient_Review
Outpatient_Chart_Review:Pediatric_Cardiology	Outpatient_Chart_Review	Pediatric_Cardiology	Outpatient_Review
Outpatient_Chart_Review:Pediatric_Endocrinology	Outpatient_Chart_Review	Pediatric_Endocrinology	Outpatient_Review
Outpatient_Chart_Review:Pediatric_Gastroenterology	Outpatient_Chart_Review	Pediatric_Gastroenterology	Outpatient_Review
Outpatient_Chart_Review:Pediatric_Hematology/Oncology	Outpatient_Chart_Review	Pediatric_Hematology/Oncology	Outpatient_Review
Outpatient_Chart_Review:Pediatric_Infectious_Disease	Outpatient_Chart_Review	Pediatric_Infectious_Disease	Outpatient_Review
Outpatient_Chart_Review:Pediatric_Nephrology	Outpatient_Chart_Review	Pediatric_Nephrology	Outpatient_Review
Outpatient_Chart_Review:Pediatric_Neurology	Outpatient_Chart_Review	Pediatric_Neurology	Outpatient_Review
Outpatient_Chart_Review:Pediatrics	Outpatient_Chart_Review	Pediatrics	Outpatient_Review
Outpatient_Chart_Review:Perinatology	Outpatient_Chart_Review	Perinatology	Outpatient_Review
Outpatient_Chart_Review:Peritoneal_Dialysis	Outpatient_Chart_Review	Peritoneal_Dialysis	Outpatient_Review
Outpatient_Chart_Review:Pet_Scan	Outpatient_Chart_Review	Pet_Scan	Outpatient_Review
Outpatient_Chart_Review:Pharmacy	Outpatient_Chart_Review	Pharmacy	Outpatient_Review
Outpatient_Chart_Review:Physical_Medicine	Outpatient_Chart_Review	Physical_Medicine	Outpatient_Review
Outpatient_Chart_Review:Physical_Therapy	Outpatient_Chart_Review	Physical_Therapy	Outpatient_Review
Outpatient_Chart_Review:Plastic_Surgery	Outpatient_Chart_Review	Plastic_Surgery	Outpatient_Review
Outpatient_Chart_Review:Podiatry	Outpatient_Chart_Review	Podiatry	Outpatient_Review
Outpatient_Chart_Review:Population_Care_Management	Outpatient_Chart_Review	Population_Care_Management	Outpatient_Review
Outpatient_Chart_Review:Pre-operative_Medicine	Outpatient_Chart_Review	Pre-operative_Medicine	Outpatient_Review
Outpatient_Chart_Review:Primary_Care	Outpatient_Chart_Review	Primary_Care	Outpatient_Review
Outpatient_Chart_Review:Procedure_Room	Outpatient_Chart_Review	Procedure_Room	Outpatient_Review
Outpatient_Chart_Review:Psychiatry	Outpatient_Chart_Review	Psychiatry	Outpatient_Review
Outpatient_Chart_Review:Psychiatry_Geriatric	Outpatient_Chart_Review	Psychiatry_Geriatric	Outpatient_Review
Outpatient_Chart_Review:Pulmonary_Diseases	Outpatient_Chart_Review	Pulmonary_Diseases	Outpatient_Review
Outpatient_Chart_Review:Pulmonary_Funct_Lab	Outpatient_Chart_Review	Pulmonary_Funct_Lab	Outpatient_Review
Outpatient_Chart_Review:Radiation_Oncology	Outpatient_Chart_Review	Radiation_Oncology	Outpatient_Review
Outpatient_Chart_Review:Radiology	Outpatient_Chart_Review	Radiology	Outpatient_Review
Outpatient_Chart_Review:Research_Medicine	Outpatient_Chart_Review	Research_Medicine	Outpatient_Review
Outpatient_Chart_Review:Respiratory_Case_Management	Outpatient_Chart_Review	Respiratory_Case_Management	Outpatient_Review
Outpatient_Chart_Review:Respiratory_Therapy	Outpatient_Chart_Review	Respiratory_Therapy	Outpatient_Review
Outpatient_Chart_Review:Rheumatology	Outpatient_Chart_Review	Rheumatology	Outpatient_Review
Outpatient_Chart_Review:Sleep_Clinic	Outpatient_Chart_Review	Sleep_Clinic	Outpatient_Review
Outpatient_Chart_Review:Sleep_Medicine	Outpatient_Chart_Review	Sleep_Medicine	Outpatient_Review
Outpatient_Chart_Review:Social_Services	Outpatient_Chart_Review	Social_Services	Outpatient_Review
Outpatient_Chart_Review:Speech_Therapy	Outpatient_Chart_Review	Speech_Therapy	Outpatient_Review
Outpatient_Chart_Review:Sports_Medicine	Outpatient_Chart_Review	Sports_Medicine	Outpatient_Review
Outpatient_Chart_Review:Surgery_Ambulatory	Outpatient_Chart_Review	Surgery_Ambulatory	Outpatient_Review
Outpatient_Chart_Review:Surgery_Cardiovascular	Outpatient_Chart_Review	Surgery_Cardiovascular	Outpatient_Review
Outpatient_Chart_Review:Surgery_General	Outpatient_Chart_Review	Surgery_General	Outpatient_Review
Outpatient_Chart_Review:Surgery_Maxillofacial	Outpatient_Chart_Review	Surgery_Maxillofacial	Outpatient_Review
Outpatient_Chart_Review:Surgery_Vascular	Outpatient_Chart_Review	Surgery_Vascular	Outpatient_Review
Outpatient_Chart_Review:Temporal_Mandibular_Disorder	Outpatient_Chart_Review	Temporal_Mandibular_Disorder	Outpatient_Review
Outpatient_Chart_Review:TRANSCRIPTION	Outpatient_Chart_Review	TRANSCRIPTION	Outpatient_Review
Outpatient_Chart_Review:Travel_Medicine	Outpatient_Chart_Review	Travel_Medicine	Outpatient_Review
Outpatient_Chart_Review:Tumor_Registry	Outpatient_Chart_Review	Tumor_Registry	Outpatient_Review
Outpatient_Chart_Review:Ultrasound	Outpatient_Chart_Review	Ultrasound	Outpatient_Review
Outpatient_Chart_Review:Urgent_Care	Outpatient_Chart_Review	Urgent_Care	Outpatient_Review
Outpatient_Chart_Review:Urology	Outpatient_Chart_Review	Urology	Outpatient_Review
Outpatient_Chart_Review:Weight_Management	Outpatient_Chart_Review	Weight_Management	Outpatient_Review
Outpatient_Chart_Review:Wound_Care	Outpatient_Chart_Review	Wound_Care	Outpatient_Review
Outpatient_Chart_Review	Outpatient_Chart_Review		Outpatient_Review
Outpatient_Email:Addiction_Medicine	Outpatient_Email	Addiction_Medicine	Outpatient_Communication
Outpatient_Email:Addiction_Medicine_Day_Treatment	Outpatient_Email	Addiction_Medicine_Day_Treatment	Outpatient_Communication
Outpatient_Email:Administration	Outpatient_Email	Administration	Outpatient_Communication
Outpatient_Email:Allergy_Asthma_and_Immunology	Outpatient_Email	Allergy_Asthma_and_Immunology	Outpatient_Communication
Outpatient_Email:Alternative_Medicine	Outpatient_Email	Alternative_Medicine	Outpatient_Communication
Outpatient_Email:Ambulatory_Surgery	Outpatient_Email	Ambulatory_Surgery	Outpatient_Communication
Outpatient_Email:Anesthesiology	Outpatient_Email	Anesthesiology	Outpatient_Communication
Outpatient_Email:Anti-Coagulation_Services	Outpatient_Email	Anti-Coagulation_Services	Outpatient_Communication
Outpatient_Email:Audiology	Outpatient_Email	Audiology	Outpatient_Communication
Outpatient_Email:Behavioral_Health	Outpatient_Email	Behavioral_Health	Outpatient_Communication
Outpatient_Email:Call_Center	Outpatient_Email	Call_Center	Outpatient_Communication
Outpatient_Email:Cardiology	Outpatient_Email	Cardiology	Outpatient_Communication
Outpatient_Email:Case_Management	Outpatient_Email	Case_Management	Outpatient_Communication
Outpatient_Email:Catscan	Outpatient_Email	Catscan	Outpatient_Communication
Outpatient_Email:Continuing_Care	Outpatient_Email	Continuing_Care	Outpatient_Communication
Outpatient_Email:Critical_Care_Medicine	Outpatient_Email	Critical_Care_Medicine	Outpatient_Communication
Outpatient_Email:Dentistry	Outpatient_Email	Dentistry	Outpatient_Communication
Outpatient_Email:Dermatology	Outpatient_Email	Dermatology	Outpatient_Communication
Outpatient_Email:Diabetes_Services	Outpatient_Email	Diabetes_Services	Outpatient_Communication
Outpatient_Email:Durable_Medical_Equipment	Outpatient_Email	Durable_Medical_Equipment	Outpatient_Communication
Outpatient_Email:EEG	Outpatient_Email	EEG	Outpatient_Communication
Outpatient_Email:Emergency_Medicine	Outpatient_Email	Emergency_Medicine	Outpatient_Communication
Outpatient_Email:Endocrinology_Diabetes/Metabolism	Outpatient_Email	Endocrinology_Diabetes/Metabolism	Outpatient_Communication
Outpatient_Email:Endodontics	Outpatient_Email	Endodontics	Outpatient_Communication
Outpatient_Email:Endoscopy	Outpatient_Email	Endoscopy	Outpatient_Communication
Outpatient_Email:Expanded_Care	Outpatient_Email	Expanded_Care	Outpatient_Communication
Outpatient_Email:Eye_Care_Imaging	Outpatient_Email	Eye_Care_Imaging	Outpatient_Communication
Outpatient_Email:Family_Practice	Outpatient_Email	Family_Practice	Outpatient_Communication
Outpatient_Email:Foot_Care	Outpatient_Email	Foot_Care	Outpatient_Communication
Outpatient_Email:Fracture_Clinic	Outpatient_Email	Fracture_Clinic	Outpatient_Communication
Outpatient_Email:Gastroenterology	Outpatient_Email	Gastroenterology	Outpatient_Communication
Outpatient_Email:Genetics	Outpatient_Email	Genetics	Outpatient_Communication
Outpatient_Email:Geriatric_Medicine	Outpatient_Email	Geriatric_Medicine	Outpatient_Communication
Outpatient_Email:Gynecology	Outpatient_Email	Gynecology	Outpatient_Communication
Outpatient_Email:Gynecology_Urology	Outpatient_Email	Gynecology_Urology	Outpatient_Communication
Outpatient_Email:Health_Appraisal	Outpatient_Email	Health_Appraisal	Outpatient_Communication
Outpatient_Email:Health_Education	Outpatient_Email	Health_Education	Outpatient_Communication
Outpatient_Email:Health_Systems	Outpatient_Email	Health_Systems	Outpatient_Communication
Outpatient_Email:Hematology/Oncology	Outpatient_Email	Hematology/Oncology	Outpatient_Communication
Outpatient_Email:Home_Health_Care	Outpatient_Email	Home_Health_Care	Outpatient_Communication
Outpatient_Email:Hospice_Care	Outpatient_Email	Hospice_Care	Outpatient_Communication
Outpatient_Email:Immunology	Outpatient_Email	Immunology	Outpatient_Communication
Outpatient_Email:Infectious_Diseases	Outpatient_Email	Infectious_Diseases	Outpatient_Communication
Outpatient_Email:Infusion_Therapy	Outpatient_Email	Infusion_Therapy	Outpatient_Communication
Outpatient_Email:Inpatient	Outpatient_Email	Inpatient	Outpatient_Communication
Outpatient_Email:Insomnia_Evaluation	Outpatient_Email	Insomnia_Evaluation	Outpatient_Communication
Outpatient_Email:Internal_Medicine	Outpatient_Email	Internal_Medicine	Outpatient_Communication
Outpatient_Email:K.P._Recovery_Resources	Outpatient_Email	K.P._Recovery_Resources	Outpatient_Communication
Outpatient_Email:Labor_&_Delivery	Outpatient_Email	Labor_&_Delivery	Outpatient_Communication
Outpatient_Email:Laboratory	Outpatient_Email	Laboratory	Outpatient_Communication
Outpatient_Email:Lifestyle_Medicine	Outpatient_Email	Lifestyle_Medicine	Outpatient_Communication
Outpatient_Email:Magnet_Resonance_Img	Outpatient_Email	Magnet_Resonance_Img	Outpatient_Communication
Outpatient_Email:Mammography	Outpatient_Email	Mammography	Outpatient_Communication
Outpatient_Email:Medical_Ambulatory_Care	Outpatient_Email	Medical_Ambulatory_Care	Outpatient_Communication
Outpatient_Email:Mental_Health_IOP	Outpatient_Email	Mental_Health_IOP	Outpatient_Communication
Outpatient_Email:Minor_Injury_Clinic	Outpatient_Email	Minor_Injury_Clinic	Outpatient_Communication
Outpatient_Email:Mohs_Surgery_Services	Outpatient_Email	Mohs_Surgery_Services	Outpatient_Communication
Outpatient_Email:NA	Outpatient_Email	NA	Outpatient_Communication
Outpatient_Email:Neonatology	Outpatient_Email	Neonatology	Outpatient_Communication
Outpatient_Email:Nephrology	Outpatient_Email	Nephrology	Outpatient_Communication
Outpatient_Email:Neurology	Outpatient_Email	Neurology	Outpatient_Communication
Outpatient_Email:Neurosurgery	Outpatient_Email	Neurosurgery	Outpatient_Communication
Outpatient_Email:Not_Elsewhere_Classified	Outpatient_Email	Not_Elsewhere_Classified	Outpatient_Communication
Outpatient_Email:Nuclear_Medicine	Outpatient_Email	Nuclear_Medicine	Outpatient_Communication
Outpatient_Email:Nurse_Treatment_Room	Outpatient_Email	Nurse_Treatment_Room	Outpatient_Communication
Outpatient_Email:Nurse_Visit	Outpatient_Email	Nurse_Visit	Outpatient_Communication
Outpatient_Email:Nutritional_Services	Outpatient_Email	Nutritional_Services	Outpatient_Communication
Outpatient_Email:Obstetrics_Gynecology	Outpatient_Email	Obstetrics_Gynecology	Outpatient_Communication
Outpatient_Email:Occupational_Medicine	Outpatient_Email	Occupational_Medicine	Outpatient_Communication
Outpatient_Email:Occupational_Therapy	Outpatient_Email	Occupational_Therapy	Outpatient_Communication
Outpatient_Email:Oncology	Outpatient_Email	Oncology	Outpatient_Communication
Outpatient_Email:Ophthalmology	Outpatient_Email	Ophthalmology	Outpatient_Communication
Outpatient_Email:Optometry	Outpatient_Email	Optometry	Outpatient_Communication
Outpatient_Email:Orthodontics	Outpatient_Email	Orthodontics	Outpatient_Communication
Outpatient_Email:Orthopedic_Surgery	Outpatient_Email	Orthopedic_Surgery	Outpatient_Communication
Outpatient_Email:Otolaryngology	Outpatient_Email	Otolaryngology	Outpatient_Communication
Outpatient_Email:Pain_Management	Outpatient_Email	Pain_Management	Outpatient_Communication
Outpatient_Email:Palliative_Care	Outpatient_Email	Palliative_Care	Outpatient_Communication
Outpatient_Email:Palliative_Care_Home	Outpatient_Email	Palliative_Care_Home	Outpatient_Communication
Outpatient_Email:Pediatric_Cardiology	Outpatient_Email	Pediatric_Cardiology	Outpatient_Communication
Outpatient_Email:Pediatric_Dentistry	Outpatient_Email	Pediatric_Dentistry	Outpatient_Communication
Outpatient_Email:Pediatric_Endocrinology	Outpatient_Email	Pediatric_Endocrinology	Outpatient_Communication
Outpatient_Email:Pediatric_Gastroenterology	Outpatient_Email	Pediatric_Gastroenterology	Outpatient_Communication
Outpatient_Email:Pediatric_Hematology/Oncology	Outpatient_Email	Pediatric_Hematology/Oncology	Outpatient_Communication
Outpatient_Email:Pediatric_Infectious_Disease	Outpatient_Email	Pediatric_Infectious_Disease	Outpatient_Communication
Outpatient_Email:Pediatric_Nephrology	Outpatient_Email	Pediatric_Nephrology	Outpatient_Communication
Outpatient_Email:Pediatric_Neurology	Outpatient_Email	Pediatric_Neurology	Outpatient_Communication
Outpatient_Email:Pediatric_Pulmonology	Outpatient_Email	Pediatric_Pulmonology	Outpatient_Communication
Outpatient_Email:Pediatrics	Outpatient_Email	Pediatrics	Outpatient_Communication
Outpatient_Email:Perinatology	Outpatient_Email	Perinatology	Outpatient_Communication
Outpatient_Email:Peritoneal_Dialysis	Outpatient_Email	Peritoneal_Dialysis	Outpatient_Communication
Outpatient_Email:Pharmacy	Outpatient_Email	Pharmacy	Outpatient_Communication
Outpatient_Email:Physical_Medicine	Outpatient_Email	Physical_Medicine	Outpatient_Communication
Outpatient_Email:Physical_Therapy	Outpatient_Email	Physical_Therapy	Outpatient_Communication
Outpatient_Email:Plastic_Surgery	Outpatient_Email	Plastic_Surgery	Outpatient_Communication
Outpatient_Email:Podiatry	Outpatient_Email	Podiatry	Outpatient_Communication
Outpatient_Email:Population_Care_Management	Outpatient_Email	Population_Care_Management	Outpatient_Communication
Outpatient_Email:Pre-operative_Medicine	Outpatient_Email	Pre-operative_Medicine	Outpatient_Communication
Outpatient_Email:Primary_Care	Outpatient_Email	Primary_Care	Outpatient_Communication
Outpatient_Email:Procedure_Room	Outpatient_Email	Procedure_Room	Outpatient_Communication
Outpatient_Email:Psychiatry	Outpatient_Email	Psychiatry	Outpatient_Communication
Outpatient_Email:Psychiatry_Geriatric	Outpatient_Email	Psychiatry_Geriatric	Outpatient_Communication
Outpatient_Email:Pulmonary_Diseases	Outpatient_Email	Pulmonary_Diseases	Outpatient_Communication
Outpatient_Email:Pulmonary_Funct_Lab	Outpatient_Email	Pulmonary_Funct_Lab	Outpatient_Communication
Outpatient_Email:Radiation_Oncology	Outpatient_Email	Radiation_Oncology	Outpatient_Communication
Outpatient_Email:Radiology	Outpatient_Email	Radiology	Outpatient_Communication
Outpatient_Email:Research_Medicine	Outpatient_Email	Research_Medicine	Outpatient_Communication
Outpatient_Email:Respiratory_Case_Management	Outpatient_Email	Respiratory_Case_Management	Outpatient_Communication
Outpatient_Email:Respiratory_Therapy	Outpatient_Email	Respiratory_Therapy	Outpatient_Communication
Outpatient_Email:Rheumatology	Outpatient_Email	Rheumatology	Outpatient_Communication
Outpatient_Email:Sleep_Clinic	Outpatient_Email	Sleep_Clinic	Outpatient_Communication
Outpatient_Email:Sleep_Medicine	Outpatient_Email	Sleep_Medicine	Outpatient_Communication
Outpatient_Email:Sleep_Studies	Outpatient_Email	Sleep_Studies	Outpatient_Communication
Outpatient_Email:Social_Services	Outpatient_Email	Social_Services	Outpatient_Communication
Outpatient_Email:Speech_Therapy	Outpatient_Email	Speech_Therapy	Outpatient_Communication
Outpatient_Email:Sports_Medicine	Outpatient_Email	Sports_Medicine	Outpatient_Communication
Outpatient_Email:Surgery_Ambulatory	Outpatient_Email	Surgery_Ambulatory	Outpatient_Communication
Outpatient_Email:Surgery_Cardiovascular	Outpatient_Email	Surgery_Cardiovascular	Outpatient_Communication
Outpatient_Email:Surgery_General	Outpatient_Email	Surgery_General	Outpatient_Communication
Outpatient_Email:Surgery_Maxillofacial	Outpatient_Email	Surgery_Maxillofacial	Outpatient_Communication
Outpatient_Email:Surgery_Vascular	Outpatient_Email	Surgery_Vascular	Outpatient_Communication
Outpatient_Email:Temporal_Mandibular_Disorder	Outpatient_Email	Temporal_Mandibular_Disorder	Outpatient_Communication
Outpatient_Email:Travel_Medicine	Outpatient_Email	Travel_Medicine	Outpatient_Communication
Outpatient_Email:Ultrasound	Outpatient_Email	Ultrasound	Outpatient_Communication
Outpatient_Email:Urgent_Care	Outpatient_Email	Urgent_Care	Outpatient_Communication
Outpatient_Email:Urology	Outpatient_Email	Urology	Outpatient_Communication
Outpatient_Email:Weight_Management	Outpatient_Email	Weight_Management	Outpatient_Communication
Outpatient_Email:Wound_Care	Outpatient_Email	Wound_Care	Outpatient_Communication
Outpatient_Email	Outpatient_Email		Outpatient_Communication
Outpatient_Other:Emergency_Medicine	Outpatient_Other	Emergency_Medicine	Outpatient
Outpatient_Other:Family_Practice	Outpatient_Other	Family_Practice	Outpatient
Outpatient_Other:Geriatric_Medicine	Outpatient_Other	Geriatric_Medicine	Outpatient
Outpatient_Other:Immunology	Outpatient_Other	Immunology	Outpatient
Outpatient_Other:Internal_Medicine	Outpatient_Other	Internal_Medicine	Outpatient
Outpatient_Other:NA	Outpatient_Other	NA	Outpatient
Outpatient_Other:Nutritional_Services	Outpatient_Other	Nutritional_Services	Outpatient
Outpatient_Other:Obstetrics_Gynecology	Outpatient_Other	Obstetrics_Gynecology	Outpatient
Outpatient_Other:Palliative_Care_Home	Outpatient_Other	Palliative_Care_Home	Outpatient
Outpatient_Other:Pharmacy	Outpatient_Other	Pharmacy	Outpatient
Outpatient_Other:Psychiatry	Outpatient_Other	Psychiatry	Outpatient
Outpatient_Other:Pulmonary_Diseases	Outpatient_Other	Pulmonary_Diseases	Outpatient
Outpatient_Other:Sleep_Medicine	Outpatient_Other	Sleep_Medicine	Outpatient
Outpatient_Other:Urology	Outpatient_Other	Urology	Outpatient
Outpatient_Other	Outpatient_Other		Outpatient
Outpatient_Procedure_Only:Addiction_Medicine	Outpatient_Procedure_Only	Addiction_Medicine	Outpatient
Outpatient_Procedure_Only:Administration	Outpatient_Procedure_Only	Administration	Outpatient
Outpatient_Procedure_Only:Allergy_Asthma_and_Immunology	Outpatient_Procedure_Only	Allergy_Asthma_and_Immunology	Outpatient
Outpatient_Procedure_Only:Alternative_Medicine	Outpatient_Procedure_Only	Alternative_Medicine	Outpatient
Outpatient_Procedure_Only:Ambulatory_Care_Unit	Outpatient_Procedure_Only	Ambulatory_Care_Unit	Outpatient
Outpatient_Procedure_Only:Ambulatory_Surgery	Outpatient_Procedure_Only	Ambulatory_Surgery	Outpatient
Outpatient_Procedure_Only:Anesthesiology	Outpatient_Procedure_Only	Anesthesiology	Outpatient
Outpatient_Procedure_Only:Audiology	Outpatient_Procedure_Only	Audiology	Outpatient
Outpatient_Procedure_Only:Behavioral_Health	Outpatient_Procedure_Only	Behavioral_Health	Outpatient
Outpatient_Procedure_Only:Bone_Density	Outpatient_Procedure_Only	Bone_Density	Outpatient
Outpatient_Procedure_Only:Call_Center	Outpatient_Procedure_Only	Call_Center	Outpatient
Outpatient_Procedure_Only:Cardiology	Outpatient_Procedure_Only	Cardiology	Outpatient
Outpatient_Procedure_Only:Case_Management	Outpatient_Procedure_Only	Case_Management	Outpatient
Outpatient_Procedure_Only:Catscan	Outpatient_Procedure_Only	Catscan	Outpatient
Outpatient_Procedure_Only:Continuing_Care	Outpatient_Procedure_Only	Continuing_Care	Outpatient
Outpatient_Procedure_Only:Critical_Care_Medicine	Outpatient_Procedure_Only	Critical_Care_Medicine	Outpatient
Outpatient_Procedure_Only:Dentistry	Outpatient_Procedure_Only	Dentistry	Outpatient
Outpatient_Procedure_Only:Dermatology	Outpatient_Procedure_Only	Dermatology	Outpatient
Outpatient_Procedure_Only:Diabetes_Services	Outpatient_Procedure_Only	Diabetes_Services	Outpatient
Outpatient_Procedure_Only:Durable_Medical_Equipment	Outpatient_Procedure_Only	Durable_Medical_Equipment	Outpatient
Outpatient_Procedure_Only:EEG	Outpatient_Procedure_Only	EEG	Outpatient
Outpatient_Procedure_Only:Emergency_Case_Mgt	Outpatient_Procedure_Only	Emergency_Case_Mgt	Outpatient
Outpatient_Procedure_Only:Emergency_Medicine	Outpatient_Procedure_Only	Emergency_Medicine	Outpatient
Outpatient_Procedure_Only:Emergicenter	Outpatient_Procedure_Only	Emergicenter	Outpatient
Outpatient_Procedure_Only:Employee_Health	Outpatient_Procedure_Only	Employee_Health	Outpatient
Outpatient_Procedure_Only:Endocrinology_Diabetes/Metabolism	Outpatient_Procedure_Only	Endocrinology_Diabetes/Metabolism	Outpatient
Outpatient_Procedure_Only:Endoscopy	Outpatient_Procedure_Only	Endoscopy	Outpatient
Outpatient_Procedure_Only:Eye_Care_Imaging	Outpatient_Procedure_Only	Eye_Care_Imaging	Outpatient
Outpatient_Procedure_Only:Family_Practice	Outpatient_Procedure_Only	Family_Practice	Outpatient
Outpatient_Procedure_Only:Foot_Care	Outpatient_Procedure_Only	Foot_Care	Outpatient
Outpatient_Procedure_Only:Fracture_Clinic	Outpatient_Procedure_Only	Fracture_Clinic	Outpatient
Outpatient_Procedure_Only:Gastroenterology	Outpatient_Procedure_Only	Gastroenterology	Outpatient
Outpatient_Procedure_Only:Genetics	Outpatient_Procedure_Only	Genetics	Outpatient
Outpatient_Procedure_Only:Geriatric_Medicine	Outpatient_Procedure_Only	Geriatric_Medicine	Outpatient
Outpatient_Procedure_Only:Gynecology_Urology	Outpatient_Procedure_Only	Gynecology_Urology	Outpatient
Outpatient_Procedure_Only:Health_Education	Outpatient_Procedure_Only	Health_Education	Outpatient
Outpatient_Procedure_Only:Health_Systems	Outpatient_Procedure_Only	Health_Systems	Outpatient
Outpatient_Procedure_Only:Home_Health_Care	Outpatient_Procedure_Only	Home_Health_Care	Outpatient
Outpatient_Procedure_Only:Immunology	Outpatient_Procedure_Only	Immunology	Outpatient
Outpatient_Procedure_Only:Infectious_Diseases	Outpatient_Procedure_Only	Infectious_Diseases	Outpatient
Outpatient_Procedure_Only:Infusion_Therapy	Outpatient_Procedure_Only	Infusion_Therapy	Outpatient
Outpatient_Procedure_Only:Insomnia_Evaluation	Outpatient_Procedure_Only	Insomnia_Evaluation	Outpatient
Outpatient_Procedure_Only:Internal_Medicine	Outpatient_Procedure_Only	Internal_Medicine	Outpatient
Outpatient_Procedure_Only:INTERVENTIONAL_RADIOLOGY	Outpatient_Procedure_Only	INTERVENTIONAL_RADIOLOGY	Outpatient
Outpatient_Procedure_Only:K.P._Recovery_Resources	Outpatient_Procedure_Only	K.P._Recovery_Resources	Outpatient
Outpatient_Procedure_Only:Labor_&_Delivery	Outpatient_Procedure_Only	Labor_&_Delivery	Outpatient
Outpatient_Procedure_Only:Laboratory	Outpatient_Procedure_Only	Laboratory	Outpatient
Outpatient_Procedure_Only:Lifestyle_Medicine	Outpatient_Procedure_Only	Lifestyle_Medicine	Outpatient
Outpatient_Procedure_Only:Magnet_Resonance_Img	Outpatient_Procedure_Only	Magnet_Resonance_Img	Outpatient
Outpatient_Procedure_Only:Mammography	Outpatient_Procedure_Only	Mammography	Outpatient
Outpatient_Procedure_Only:Medical_Ambulatory_Care	Outpatient_Procedure_Only	Medical_Ambulatory_Care	Outpatient
Outpatient_Procedure_Only:Medical_Records	Outpatient_Procedure_Only	Medical_Records	Outpatient
Outpatient_Procedure_Only:Mental_Health_IOP	Outpatient_Procedure_Only	Mental_Health_IOP	Outpatient
Outpatient_Procedure_Only:Minor_Injury_Clinic	Outpatient_Procedure_Only	Minor_Injury_Clinic	Outpatient
Outpatient_Procedure_Only:Minor_OR_1	Outpatient_Procedure_Only	Minor_OR_1	Outpatient
Outpatient_Procedure_Only:Mohs_Surgery_Services	Outpatient_Procedure_Only	Mohs_Surgery_Services	Outpatient
Outpatient_Procedure_Only:NA	Outpatient_Procedure_Only	NA	Outpatient
Outpatient_Procedure_Only:Nephrology	Outpatient_Procedure_Only	Nephrology	Outpatient
Outpatient_Procedure_Only:Neurology	Outpatient_Procedure_Only	Neurology	Outpatient
Outpatient_Procedure_Only:Neurosurgery	Outpatient_Procedure_Only	Neurosurgery	Outpatient
Outpatient_Procedure_Only:Not_Elsewhere_Classified	Outpatient_Procedure_Only	Not_Elsewhere_Classified	Outpatient
Outpatient_Procedure_Only:Nuclear_Medicine	Outpatient_Procedure_Only	Nuclear_Medicine	Outpatient
Outpatient_Procedure_Only:Nurse_Treatment_Room	Outpatient_Procedure_Only	Nurse_Treatment_Room	Outpatient
Outpatient_Procedure_Only:Nurse_Visit	Outpatient_Procedure_Only	Nurse_Visit	Outpatient
Outpatient_Procedure_Only:Nutritional_Services	Outpatient_Procedure_Only	Nutritional_Services	Outpatient
Outpatient_Procedure_Only:Obstetrics_Gynecology	Outpatient_Procedure_Only	Obstetrics_Gynecology	Outpatient
Outpatient_Procedure_Only:Occupational_Medicine	Outpatient_Procedure_Only	Occupational_Medicine	Outpatient
Outpatient_Procedure_Only:Occupational_Therapy	Outpatient_Procedure_Only	Occupational_Therapy	Outpatient
Outpatient_Procedure_Only:Oncology	Outpatient_Procedure_Only	Oncology	Outpatient
Outpatient_Procedure_Only:Ophthalmology	Outpatient_Procedure_Only	Ophthalmology	Outpatient
Outpatient_Procedure_Only:Optometry	Outpatient_Procedure_Only	Optometry	Outpatient
Outpatient_Procedure_Only:Orthopedic_Surgery	Outpatient_Procedure_Only	Orthopedic_Surgery	Outpatient
Outpatient_Procedure_Only:Otolaryngology	Outpatient_Procedure_Only	Otolaryngology	Outpatient
Outpatient_Procedure_Only:Pain_Management	Outpatient_Procedure_Only	Pain_Management	Outpatient
Outpatient_Procedure_Only:Palliative_Care	Outpatient_Procedure_Only	Palliative_Care	Outpatient
Outpatient_Procedure_Only:Palliative_Care_Home	Outpatient_Procedure_Only	Palliative_Care_Home	Outpatient
Outpatient_Procedure_Only:Pediatric_Cardiology	Outpatient_Procedure_Only	Pediatric_Cardiology	Outpatient
Outpatient_Procedure_Only:Pediatric_Endocrinology	Outpatient_Procedure_Only	Pediatric_Endocrinology	Outpatient
Outpatient_Procedure_Only:Pediatric_Gastroenterology	Outpatient_Procedure_Only	Pediatric_Gastroenterology	Outpatient
Outpatient_Procedure_Only:Pediatric_Infectious_Disease	Outpatient_Procedure_Only	Pediatric_Infectious_Disease	Outpatient
Outpatient_Procedure_Only:Pediatric_Nephrology	Outpatient_Procedure_Only	Pediatric_Nephrology	Outpatient
Outpatient_Procedure_Only:Pediatric_Neurology	Outpatient_Procedure_Only	Pediatric_Neurology	Outpatient
Outpatient_Procedure_Only:Pediatric_Pulmonology	Outpatient_Procedure_Only	Pediatric_Pulmonology	Outpatient
Outpatient_Procedure_Only:Pediatrics	Outpatient_Procedure_Only	Pediatrics	Outpatient
Outpatient_Procedure_Only:Perinatology	Outpatient_Procedure_Only	Perinatology	Outpatient
Outpatient_Procedure_Only:Peritoneal_Dialysis	Outpatient_Procedure_Only	Peritoneal_Dialysis	Outpatient
Outpatient_Procedure_Only:Pet_Scan	Outpatient_Procedure_Only	Pet_Scan	Outpatient
Outpatient_Procedure_Only:Pharmacy	Outpatient_Procedure_Only	Pharmacy	Outpatient
Outpatient_Procedure_Only:Physical_Medicine	Outpatient_Procedure_Only	Physical_Medicine	Outpatient
Outpatient_Procedure_Only:Physical_Therapy	Outpatient_Procedure_Only	Physical_Therapy	Outpatient
Outpatient_Procedure_Only:Plastic_Surgery	Outpatient_Procedure_Only	Plastic_Surgery	Outpatient
Outpatient_Procedure_Only:Podiatry	Outpatient_Procedure_Only	Podiatry	Outpatient
Outpatient_Procedure_Only:Population_Care_Management	Outpatient_Procedure_Only	Population_Care_Management	Outpatient
Outpatient_Procedure_Only:Pre-operative_Medicine	Outpatient_Procedure_Only	Pre-operative_Medicine	Outpatient
Outpatient_Procedure_Only:Preterm_Birth_Program	Outpatient_Procedure_Only	Preterm_Birth_Program	Outpatient
Outpatient_Procedure_Only:Primary_Care	Outpatient_Procedure_Only	Primary_Care	Outpatient
Outpatient_Procedure_Only:Procedure_Room	Outpatient_Procedure_Only	Procedure_Room	Outpatient
Outpatient_Procedure_Only:Psychiatry	Outpatient_Procedure_Only	Psychiatry	Outpatient
Outpatient_Procedure_Only:Psychiatry_Geriatric	Outpatient_Procedure_Only	Psychiatry_Geriatric	Outpatient
Outpatient_Procedure_Only:Pulmonary_Diseases	Outpatient_Procedure_Only	Pulmonary_Diseases	Outpatient
Outpatient_Procedure_Only:Pulmonary_Funct_Lab	Outpatient_Procedure_Only	Pulmonary_Funct_Lab	Outpatient
Outpatient_Procedure_Only:Radiation_Oncology	Outpatient_Procedure_Only	Radiation_Oncology	Outpatient
Outpatient_Procedure_Only:Radiology	Outpatient_Procedure_Only	Radiology	Outpatient
Outpatient_Procedure_Only:Research_Medicine	Outpatient_Procedure_Only	Research_Medicine	Outpatient
Outpatient_Procedure_Only:Respiratory_Case_Management	Outpatient_Procedure_Only	Respiratory_Case_Management	Outpatient
Outpatient_Procedure_Only:Respiratory_Therapy	Outpatient_Procedure_Only	Respiratory_Therapy	Outpatient
Outpatient_Procedure_Only:Rheumatology	Outpatient_Procedure_Only	Rheumatology	Outpatient
Outpatient_Procedure_Only:Sleep_Clinic	Outpatient_Procedure_Only	Sleep_Clinic	Outpatient
Outpatient_Procedure_Only:Sleep_Medicine	Outpatient_Procedure_Only	Sleep_Medicine	Outpatient
Outpatient_Procedure_Only:Social_Services	Outpatient_Procedure_Only	Social_Services	Outpatient
Outpatient_Procedure_Only:Speech_Therapy	Outpatient_Procedure_Only	Speech_Therapy	Outpatient
Outpatient_Procedure_Only:Sports_Medicine	Outpatient_Procedure_Only	Sports_Medicine	Outpatient
Outpatient_Procedure_Only:Surgery_Ambulatory	Outpatient_Procedure_Only	Surgery_Ambulatory	Outpatient
Outpatient_Procedure_Only:Surgery_Cardiovascular	Outpatient_Procedure_Only	Surgery_Cardiovascular	Outpatient
Outpatient_Procedure_Only:Surgery_General	Outpatient_Procedure_Only	Surgery_General	Outpatient
Outpatient_Procedure_Only:Surgery_Maxillofacial	Outpatient_Procedure_Only	Surgery_Maxillofacial	Outpatient
Outpatient_Procedure_Only:Surgery_Vascular	Outpatient_Procedure_Only	Surgery_Vascular	Outpatient
Outpatient_Procedure_Only:Temporal_Mandibular_Disorder	Outpatient_Procedure_Only	Temporal_Mandibular_Disorder	Outpatient
Outpatient_Procedure_Only:TRANSCRIPTION	Outpatient_Procedure_Only	TRANSCRIPTION	Outpatient
Outpatient_Procedure_Only:Ultrasound	Outpatient_Procedure_Only	Ultrasound	Outpatient
Outpatient_Procedure_Only:Urgent_Care	Outpatient_Procedure_Only	Urgent_Care	Outpatient
Outpatient_Procedure_Only:Urology	Outpatient_Procedure_Only	Urology	Outpatient
Outpatient_Procedure_Only:Weight_Management	Outpatient_Procedure_Only	Weight_Management	Outpatient
Outpatient_Procedure_Only:Wound_Care	Outpatient_Procedure_Only	Wound_Care	Outpatient
Outpatient_Procedure_Only	Outpatient_Procedure_Only		Outpatient
Outpatient_Telephone:Addiction_Medicine	Outpatient_Telephone	Addiction_Medicine	Outpatient_Communication
Outpatient_Telephone:ADHD	Outpatient_Telephone	ADHD	Outpatient_Communication
Outpatient_Telephone:Administration	Outpatient_Telephone	Administration	Outpatient_Communication
Outpatient_Telephone:Allergy_Asthma_and_Immunology	Outpatient_Telephone	Allergy_Asthma_and_Immunology	Outpatient_Communication
Outpatient_Telephone:Alternative_Medicine	Outpatient_Telephone	Alternative_Medicine	Outpatient_Communication
Outpatient_Telephone:Ambulatory_Care_Unit	Outpatient_Telephone	Ambulatory_Care_Unit	Outpatient_Communication
Outpatient_Telephone:Ambulatory_Surgery	Outpatient_Telephone	Ambulatory_Surgery	Outpatient_Communication
Outpatient_Telephone:Ancillary	Outpatient_Telephone	Ancillary	Outpatient_Communication
Outpatient_Telephone:Anesthesiology	Outpatient_Telephone	Anesthesiology	Outpatient_Communication
Outpatient_Telephone:Anti-Coagulation_Services	Outpatient_Telephone	Anti-Coagulation_Services	Outpatient_Communication
Outpatient_Telephone:Audiology	Outpatient_Telephone	Audiology	Outpatient_Communication
Outpatient_Telephone:Behavioral_Health	Outpatient_Telephone	Behavioral_Health	Outpatient_Communication
Outpatient_Telephone:Bone_Density	Outpatient_Telephone	Bone_Density	Outpatient_Communication
Outpatient_Telephone:Breast_Clinic	Outpatient_Telephone	Breast_Clinic	Outpatient_Communication
Outpatient_Telephone:Call_Center	Outpatient_Telephone	Call_Center	Outpatient_Communication
Outpatient_Telephone:Cardiology	Outpatient_Telephone	Cardiology	Outpatient_Communication
Outpatient_Telephone:Case_Management	Outpatient_Telephone	Case_Management	Outpatient_Communication
Outpatient_Telephone:Catscan	Outpatient_Telephone	Catscan	Outpatient_Communication
Outpatient_Telephone:Contact_Lenses	Outpatient_Telephone	Contact_Lenses	Outpatient_Communication
Outpatient_Telephone:Continuing_Care	Outpatient_Telephone	Continuing_Care	Outpatient_Communication
Outpatient_Telephone:Critical_Care_Medicine	Outpatient_Telephone	Critical_Care_Medicine	Outpatient_Communication
Outpatient_Telephone:Dentistry	Outpatient_Telephone	Dentistry	Outpatient_Communication
Outpatient_Telephone:Denturist	Outpatient_Telephone	Denturist	Outpatient_Communication
Outpatient_Telephone:Dermatology	Outpatient_Telephone	Dermatology	Outpatient_Communication
Outpatient_Telephone:Diabetes_Services	Outpatient_Telephone	Diabetes_Services	Outpatient_Communication
Outpatient_Telephone:Durable_Medical_Equipment	Outpatient_Telephone	Durable_Medical_Equipment	Outpatient_Communication
Outpatient_Telephone:EEG	Outpatient_Telephone	EEG	Outpatient_Communication
Outpatient_Telephone:Emergency_Case_Mgt	Outpatient_Telephone	Emergency_Case_Mgt	Outpatient_Communication
Outpatient_Telephone:Emergency_Medicine	Outpatient_Telephone	Emergency_Medicine	Outpatient_Communication
Outpatient_Telephone:Emergicenter	Outpatient_Telephone	Emergicenter	Outpatient_Communication
Outpatient_Telephone:Employee_Health	Outpatient_Telephone	Employee_Health	Outpatient_Communication
Outpatient_Telephone:Endocrinology_Diabetes/Metabolism	Outpatient_Telephone	Endocrinology_Diabetes/Metabolism	Outpatient_Communication
Outpatient_Telephone:Endodontics	Outpatient_Telephone	Endodontics	Outpatient_Communication
Outpatient_Telephone:Endoscopy	Outpatient_Telephone	Endoscopy	Outpatient_Communication
Outpatient_Telephone:Expanded_Care	Outpatient_Telephone	Expanded_Care	Outpatient_Communication
Outpatient_Telephone:Eye_Care_Imaging	Outpatient_Telephone	Eye_Care_Imaging	Outpatient_Communication
Outpatient_Telephone:Family_Practice	Outpatient_Telephone	Family_Practice	Outpatient_Communication
Outpatient_Telephone:Foot_Care	Outpatient_Telephone	Foot_Care	Outpatient_Communication
Outpatient_Telephone:Fracture_Clinic	Outpatient_Telephone	Fracture_Clinic	Outpatient_Communication
Outpatient_Telephone:Gastroenterology	Outpatient_Telephone	Gastroenterology	Outpatient_Communication
Outpatient_Telephone:Genetics	Outpatient_Telephone	Genetics	Outpatient_Communication
Outpatient_Telephone:Geriatric_Medicine	Outpatient_Telephone	Geriatric_Medicine	Outpatient_Communication
Outpatient_Telephone:Gynecology	Outpatient_Telephone	Gynecology	Outpatient_Communication
Outpatient_Telephone:Gynecology_Urology	Outpatient_Telephone	Gynecology_Urology	Outpatient_Communication
Outpatient_Telephone:Health_Appraisal	Outpatient_Telephone	Health_Appraisal	Outpatient_Communication
Outpatient_Telephone:Health_Education	Outpatient_Telephone	Health_Education	Outpatient_Communication
Outpatient_Telephone:Health_Systems	Outpatient_Telephone	Health_Systems	Outpatient_Communication
Outpatient_Telephone:Hematology/Oncology	Outpatient_Telephone	Hematology/Oncology	Outpatient_Communication
Outpatient_Telephone:Home_Health_Care	Outpatient_Telephone	Home_Health_Care	Outpatient_Communication
Outpatient_Telephone:Hospice_Care	Outpatient_Telephone	Hospice_Care	Outpatient_Communication
Outpatient_Telephone:Immunology	Outpatient_Telephone	Immunology	Outpatient_Communication
Outpatient_Telephone:Infectious_Diseases	Outpatient_Telephone	Infectious_Diseases	Outpatient_Communication
Outpatient_Telephone:Infusion_Therapy	Outpatient_Telephone	Infusion_Therapy	Outpatient_Communication
Outpatient_Telephone:Inpatient	Outpatient_Telephone	Inpatient	Outpatient_Communication
Outpatient_Telephone:Insomnia_Evaluation	Outpatient_Telephone	Insomnia_Evaluation	Outpatient_Communication
Outpatient_Telephone:Internal_Medicine	Outpatient_Telephone	Internal_Medicine	Outpatient_Communication
Outpatient_Telephone:INTERVENTIONAL_RADIOLOGY	Outpatient_Telephone	INTERVENTIONAL_RADIOLOGY	Outpatient_Communication
Outpatient_Telephone:K.P._Recovery_Resources	Outpatient_Telephone	K.P._Recovery_Resources	Outpatient_Communication
Outpatient_Telephone:Labor_&_Delivery	Outpatient_Telephone	Labor_&_Delivery	Outpatient_Communication
Outpatient_Telephone:Laboratory	Outpatient_Telephone	Laboratory	Outpatient_Communication
Outpatient_Telephone:Language_Services	Outpatient_Telephone	Language_Services	Outpatient_Communication
Outpatient_Telephone:Lifestyle_Medicine	Outpatient_Telephone	Lifestyle_Medicine	Outpatient_Communication
Outpatient_Telephone:Magnet_Resonance_Img	Outpatient_Telephone	Magnet_Resonance_Img	Outpatient_Communication
Outpatient_Telephone:Mammography	Outpatient_Telephone	Mammography	Outpatient_Communication
Outpatient_Telephone:Medical_Ambulatory_Care	Outpatient_Telephone	Medical_Ambulatory_Care	Outpatient_Communication
Outpatient_Telephone:Medical_Records	Outpatient_Telephone	Medical_Records	Outpatient_Communication
Outpatient_Telephone:Mental_Health_IOP	Outpatient_Telephone	Mental_Health_IOP	Outpatient_Communication
Outpatient_Telephone:Minor_Injury_Clinic	Outpatient_Telephone	Minor_Injury_Clinic	Outpatient_Communication
Outpatient_Telephone:Minor_OR_1	Outpatient_Telephone	Minor_OR_1	Outpatient_Communication
Outpatient_Telephone:Mohs_Surgery_Services	Outpatient_Telephone	Mohs_Surgery_Services	Outpatient_Communication
Outpatient_Telephone:NA	Outpatient_Telephone	NA	Outpatient_Communication
Outpatient_Telephone:Neonatology	Outpatient_Telephone	Neonatology	Outpatient_Communication
Outpatient_Telephone:Nephrology	Outpatient_Telephone	Nephrology	Outpatient_Communication
Outpatient_Telephone:Neurology	Outpatient_Telephone	Neurology	Outpatient_Communication
Outpatient_Telephone:Neurosurgery	Outpatient_Telephone	Neurosurgery	Outpatient_Communication
Outpatient_Telephone:Not_Elsewhere_Classified	Outpatient_Telephone	Not_Elsewhere_Classified	Outpatient_Communication
Outpatient_Telephone:Nuclear_Medicine	Outpatient_Telephone	Nuclear_Medicine	Outpatient_Communication
Outpatient_Telephone:Nurse_Treatment_Room	Outpatient_Telephone	Nurse_Treatment_Room	Outpatient_Communication
Outpatient_Telephone:Nurse_Visit	Outpatient_Telephone	Nurse_Visit	Outpatient_Communication
Outpatient_Telephone:Nutritional_Services	Outpatient_Telephone	Nutritional_Services	Outpatient_Communication
Outpatient_Telephone:Observation	Outpatient_Telephone	Observation	Outpatient_Communication
Outpatient_Telephone:Obstetrics_Gynecology	Outpatient_Telephone	Obstetrics_Gynecology	Outpatient_Communication
Outpatient_Telephone:Occupational_Medicine	Outpatient_Telephone	Occupational_Medicine	Outpatient_Communication
Outpatient_Telephone:Occupational_Therapy	Outpatient_Telephone	Occupational_Therapy	Outpatient_Communication
Outpatient_Telephone:Oncology	Outpatient_Telephone	Oncology	Outpatient_Communication
Outpatient_Telephone:Ophthalmology	Outpatient_Telephone	Ophthalmology	Outpatient_Communication
Outpatient_Telephone:Optometry	Outpatient_Telephone	Optometry	Outpatient_Communication
Outpatient_Telephone:Orthodontics	Outpatient_Telephone	Orthodontics	Outpatient_Communication
Outpatient_Telephone:Orthopedic_Surgery	Outpatient_Telephone	Orthopedic_Surgery	Outpatient_Communication
Outpatient_Telephone:Otolaryngology	Outpatient_Telephone	Otolaryngology	Outpatient_Communication
Outpatient_Telephone:Pain_Management	Outpatient_Telephone	Pain_Management	Outpatient_Communication
Outpatient_Telephone:Palliative_Care	Outpatient_Telephone	Palliative_Care	Outpatient_Communication
Outpatient_Telephone:Palliative_Care_Home	Outpatient_Telephone	Palliative_Care_Home	Outpatient_Communication
Outpatient_Telephone:Pediatric_Cardiology	Outpatient_Telephone	Pediatric_Cardiology	Outpatient_Communication
Outpatient_Telephone:Pediatric_Dentistry	Outpatient_Telephone	Pediatric_Dentistry	Outpatient_Communication
Outpatient_Telephone:Pediatric_Endocrinology	Outpatient_Telephone	Pediatric_Endocrinology	Outpatient_Communication
Outpatient_Telephone:Pediatric_Gastroenterology	Outpatient_Telephone	Pediatric_Gastroenterology	Outpatient_Communication
Outpatient_Telephone:Pediatric_Hematology/Oncology	Outpatient_Telephone	Pediatric_Hematology/Oncology	Outpatient_Communication
Outpatient_Telephone:Pediatric_Infectious_Disease	Outpatient_Telephone	Pediatric_Infectious_Disease	Outpatient_Communication
Outpatient_Telephone:Pediatric_Nephrology	Outpatient_Telephone	Pediatric_Nephrology	Outpatient_Communication
Outpatient_Telephone:Pediatric_Neurology	Outpatient_Telephone	Pediatric_Neurology	Outpatient_Communication
Outpatient_Telephone:Pediatric_Orthopaedics	Outpatient_Telephone	Pediatric_Orthopaedics	Outpatient_Communication
Outpatient_Telephone:Pediatric_Pulmonology	Outpatient_Telephone	Pediatric_Pulmonology	Outpatient_Communication
Outpatient_Telephone:Pediatrics	Outpatient_Telephone	Pediatrics	Outpatient_Communication
Outpatient_Telephone:Perinatology	Outpatient_Telephone	Perinatology	Outpatient_Communication
Outpatient_Telephone:Periodontology	Outpatient_Telephone	Periodontology	Outpatient_Communication
Outpatient_Telephone:Peritoneal_Dialysis	Outpatient_Telephone	Peritoneal_Dialysis	Outpatient_Communication
Outpatient_Telephone:Pet_Scan	Outpatient_Telephone	Pet_Scan	Outpatient_Communication
Outpatient_Telephone:Pharmacy	Outpatient_Telephone	Pharmacy	Outpatient_Communication
Outpatient_Telephone:Physical_Medicine	Outpatient_Telephone	Physical_Medicine	Outpatient_Communication
Outpatient_Telephone:Physical_Therapy	Outpatient_Telephone	Physical_Therapy	Outpatient_Communication
Outpatient_Telephone:Plastic_Surgery	Outpatient_Telephone	Plastic_Surgery	Outpatient_Communication
Outpatient_Telephone:Podiatry	Outpatient_Telephone	Podiatry	Outpatient_Communication
Outpatient_Telephone:Population_Care_Management	Outpatient_Telephone	Population_Care_Management	Outpatient_Communication
Outpatient_Telephone:Pre-operative_Medicine	Outpatient_Telephone	Pre-operative_Medicine	Outpatient_Communication
Outpatient_Telephone:Preterm_Birth_Program	Outpatient_Telephone	Preterm_Birth_Program	Outpatient_Communication
Outpatient_Telephone:Primary_Care	Outpatient_Telephone	Primary_Care	Outpatient_Communication
Outpatient_Telephone:Procedure_Room	Outpatient_Telephone	Procedure_Room	Outpatient_Communication
Outpatient_Telephone:Prosthodontics	Outpatient_Telephone	Prosthodontics	Outpatient_Communication
Outpatient_Telephone:Psychiatry	Outpatient_Telephone	Psychiatry	Outpatient_Communication
Outpatient_Telephone:Psychiatry_Geriatric	Outpatient_Telephone	Psychiatry_Geriatric	Outpatient_Communication
Outpatient_Telephone:Pulmonary_Diseases	Outpatient_Telephone	Pulmonary_Diseases	Outpatient_Communication
Outpatient_Telephone:Pulmonary_Funct_Lab	Outpatient_Telephone	Pulmonary_Funct_Lab	Outpatient_Communication
Outpatient_Telephone:Radiation_Oncology	Outpatient_Telephone	Radiation_Oncology	Outpatient_Communication
Outpatient_Telephone:Radiology	Outpatient_Telephone	Radiology	Outpatient_Communication
Outpatient_Telephone:Research_Medicine	Outpatient_Telephone	Research_Medicine	Outpatient_Communication
Outpatient_Telephone:Respiratory_Case_Management	Outpatient_Telephone	Respiratory_Case_Management	Outpatient_Communication
Outpatient_Telephone:Respiratory_Therapy	Outpatient_Telephone	Respiratory_Therapy	Outpatient_Communication
Outpatient_Telephone:Rheumatology	Outpatient_Telephone	Rheumatology	Outpatient_Communication
Outpatient_Telephone:Sciatica_Assessment	Outpatient_Telephone	Sciatica_Assessment	Outpatient_Communication
Outpatient_Telephone:Sleep_Clinic	Outpatient_Telephone	Sleep_Clinic	Outpatient_Communication
Outpatient_Telephone:Sleep_Medicine	Outpatient_Telephone	Sleep_Medicine	Outpatient_Communication
Outpatient_Telephone:Sleep_Studies	Outpatient_Telephone	Sleep_Studies	Outpatient_Communication
Outpatient_Telephone:Social_Services	Outpatient_Telephone	Social_Services	Outpatient_Communication
Outpatient_Telephone:Speech_Therapy	Outpatient_Telephone	Speech_Therapy	Outpatient_Communication
Outpatient_Telephone:Sports_Medicine	Outpatient_Telephone	Sports_Medicine	Outpatient_Communication
Outpatient_Telephone:Supply_Center	Outpatient_Telephone	Supply_Center	Outpatient_Communication
Outpatient_Telephone:Surgery_Ambulatory	Outpatient_Telephone	Surgery_Ambulatory	Outpatient_Communication
Outpatient_Telephone:Surgery_Cardiovascular	Outpatient_Telephone	Surgery_Cardiovascular	Outpatient_Communication
Outpatient_Telephone:Surgery_General	Outpatient_Telephone	Surgery_General	Outpatient_Communication
Outpatient_Telephone:Surgery_Maxillofacial	Outpatient_Telephone	Surgery_Maxillofacial	Outpatient_Communication
Outpatient_Telephone:Surgery_Vascular	Outpatient_Telephone	Surgery_Vascular	Outpatient_Communication
Outpatient_Telephone:Temporal_Mandibular_Disorder	Outpatient_Telephone	Temporal_Mandibular_Disorder	Outpatient_Communication
Outpatient_Telephone:TRANSCRIPTION	Outpatient_Telephone	TRANSCRIPTION	Outpatient_Communication
Outpatient_Telephone:Travel_Medicine	Outpatient_Telephone	Travel_Medicine	Outpatient_Communication
Outpatient_Telephone:Tumor_Registry	Outpatient_Telephone	Tumor_Registry	Outpatient_Communication
Outpatient_Telephone:Ultrasound	Outpatient_Telephone	Ultrasound	Outpatient_Communication
Outpatient_Telephone:Urgent_Care	Outpatient_Telephone	Urgent_Care	Outpatient_Communication
Outpatient_Telephone:Urology	Outpatient_Telephone	Urology	Outpatient_Communication
Outpatient_Telephone:Weight_Management	Outpatient_Telephone	Weight_Management	Outpatient_Communication
Outpatient_Telephone:Wound_Care	Outpatient_Telephone	Wound_Care	Outpatient_Communication
Outpatient_Telephone	Outpatient_Telephone		Outpatient_Communication
Outpatient_Video_Visit:Allergy_Asthma_and_Immunology	Outpatient_Video_Visit	Allergy_Asthma_and_Immunology	Outpatient
Outpatient_Video_Visit:Alternative_Medicine	Outpatient_Video_Visit	Alternative_Medicine	Outpatient
Outpatient_Video_Visit:Anti-Coagulation_Services	Outpatient_Video_Visit	Anti-Coagulation_Services	Outpatient
Outpatient_Video_Visit:Cardiology	Outpatient_Video_Visit	Cardiology	Outpatient
Outpatient_Video_Visit:Continuing_Care	Outpatient_Video_Visit	Continuing_Care	Outpatient
Outpatient_Video_Visit:Dermatology	Outpatient_Video_Visit	Dermatology	Outpatient
Outpatient_Video_Visit:Emergency_Medicine	Outpatient_Video_Visit	Emergency_Medicine	Outpatient
Outpatient_Video_Visit:Endocrinology_Diabetes/Metabolism	Outpatient_Video_Visit	Endocrinology_Diabetes/Metabolism	Outpatient
Outpatient_Video_Visit:Family_Practice	Outpatient_Video_Visit	Family_Practice	Outpatient
Outpatient_Video_Visit:Fracture_Clinic	Outpatient_Video_Visit	Fracture_Clinic	Outpatient
Outpatient_Video_Visit:Gastroenterology	Outpatient_Video_Visit	Gastroenterology	Outpatient
Outpatient_Video_Visit:Genetics	Outpatient_Video_Visit	Genetics	Outpatient
Outpatient_Video_Visit:Geriatric_Medicine	Outpatient_Video_Visit	Geriatric_Medicine	Outpatient
Outpatient_Video_Visit:Health_Education	Outpatient_Video_Visit	Health_Education	Outpatient
Outpatient_Video_Visit:Home_Health_Care	Outpatient_Video_Visit	Home_Health_Care	Outpatient
Outpatient_Video_Visit:Immunology	Outpatient_Video_Visit	Immunology	Outpatient
Outpatient_Video_Visit:Infectious_Diseases	Outpatient_Video_Visit	Infectious_Diseases	Outpatient
Outpatient_Video_Visit:Internal_Medicine	Outpatient_Video_Visit	Internal_Medicine	Outpatient
Outpatient_Video_Visit:K.P._Recovery_Resources	Outpatient_Video_Visit	K.P._Recovery_Resources	Outpatient
Outpatient_Video_Visit:Mental_Health_IOP	Outpatient_Video_Visit	Mental_Health_IOP	Outpatient
Outpatient_Video_Visit:Mohs_Surgery_Services	Outpatient_Video_Visit	Mohs_Surgery_Services	Outpatient
Outpatient_Video_Visit:NA	Outpatient_Video_Visit	NA	Outpatient
Outpatient_Video_Visit:Neonatology	Outpatient_Video_Visit	Neonatology	Outpatient
Outpatient_Video_Visit:Nephrology	Outpatient_Video_Visit	Nephrology	Outpatient
Outpatient_Video_Visit:Neurology	Outpatient_Video_Visit	Neurology	Outpatient
Outpatient_Video_Visit:Neurosurgery	Outpatient_Video_Visit	Neurosurgery	Outpatient
Outpatient_Video_Visit:Nurse_Treatment_Room	Outpatient_Video_Visit	Nurse_Treatment_Room	Outpatient
Outpatient_Video_Visit:Nurse_Visit	Outpatient_Video_Visit	Nurse_Visit	Outpatient
Outpatient_Video_Visit:Nutritional_Services	Outpatient_Video_Visit	Nutritional_Services	Outpatient
Outpatient_Video_Visit:Obstetrics_Gynecology	Outpatient_Video_Visit	Obstetrics_Gynecology	Outpatient
Outpatient_Video_Visit:Occupational_Medicine	Outpatient_Video_Visit	Occupational_Medicine	Outpatient
Outpatient_Video_Visit:Occupational_Therapy	Outpatient_Video_Visit	Occupational_Therapy	Outpatient
Outpatient_Video_Visit:Oncology	Outpatient_Video_Visit	Oncology	Outpatient
Outpatient_Video_Visit:Ophthalmology	Outpatient_Video_Visit	Ophthalmology	Outpatient
Outpatient_Video_Visit:Optometry	Outpatient_Video_Visit	Optometry	Outpatient
Outpatient_Video_Visit:Orthopedic_Surgery	Outpatient_Video_Visit	Orthopedic_Surgery	Outpatient
Outpatient_Video_Visit:Otolaryngology	Outpatient_Video_Visit	Otolaryngology	Outpatient
Outpatient_Video_Visit:Pain_Management	Outpatient_Video_Visit	Pain_Management	Outpatient
Outpatient_Video_Visit:Palliative_Care	Outpatient_Video_Visit	Palliative_Care	Outpatient
Outpatient_Video_Visit:Palliative_Care_Home	Outpatient_Video_Visit	Palliative_Care_Home	Outpatient
Outpatient_Video_Visit:Pediatric_Gastroenterology	Outpatient_Video_Visit	Pediatric_Gastroenterology	Outpatient
Outpatient_Video_Visit:Pediatric_Hematology/Oncology	Outpatient_Video_Visit	Pediatric_Hematology/Oncology	Outpatient
Outpatient_Video_Visit:Pediatric_Infectious_Disease	Outpatient_Video_Visit	Pediatric_Infectious_Disease	Outpatient
Outpatient_Video_Visit:Pediatric_Nephrology	Outpatient_Video_Visit	Pediatric_Nephrology	Outpatient
Outpatient_Video_Visit:Pediatrics	Outpatient_Video_Visit	Pediatrics	Outpatient
Outpatient_Video_Visit:Perinatology	Outpatient_Video_Visit	Perinatology	Outpatient
Outpatient_Video_Visit:Peritoneal_Dialysis	Outpatient_Video_Visit	Peritoneal_Dialysis	Outpatient
Outpatient_Video_Visit:Pharmacy	Outpatient_Video_Visit	Pharmacy	Outpatient
Outpatient_Video_Visit:Physical_Medicine	Outpatient_Video_Visit	Physical_Medicine	Outpatient
Outpatient_Video_Visit:Physical_Therapy	Outpatient_Video_Visit	Physical_Therapy	Outpatient
Outpatient_Video_Visit:Plastic_Surgery	Outpatient_Video_Visit	Plastic_Surgery	Outpatient
Outpatient_Video_Visit:Podiatry	Outpatient_Video_Visit	Podiatry	Outpatient
Outpatient_Video_Visit:Pre-operative_Medicine	Outpatient_Video_Visit	Pre-operative_Medicine	Outpatient
Outpatient_Video_Visit:Psychiatry	Outpatient_Video_Visit	Psychiatry	Outpatient
Outpatient_Video_Visit:Psychiatry_Geriatric	Outpatient_Video_Visit	Psychiatry_Geriatric	Outpatient
Outpatient_Video_Visit:Pulmonary_Diseases	Outpatient_Video_Visit	Pulmonary_Diseases	Outpatient
Outpatient_Video_Visit:Radiation_Oncology	Outpatient_Video_Visit	Radiation_Oncology	Outpatient
Outpatient_Video_Visit:Radiology	Outpatient_Video_Visit	Radiology	Outpatient
Outpatient_Video_Visit:Rheumatology	Outpatient_Video_Visit	Rheumatology	Outpatient
Outpatient_Video_Visit:Sleep_Medicine	Outpatient_Video_Visit	Sleep_Medicine	Outpatient
Outpatient_Video_Visit:Social_Services	Outpatient_Video_Visit	Social_Services	Outpatient
Outpatient_Video_Visit:Speech_Therapy	Outpatient_Video_Visit	Speech_Therapy	Outpatient
Outpatient_Video_Visit:Surgery_Cardiovascular	Outpatient_Video_Visit	Surgery_Cardiovascular	Outpatient
Outpatient_Video_Visit:Surgery_General	Outpatient_Video_Visit	Surgery_General	Outpatient
Outpatient_Video_Visit:Surgery_Vascular	Outpatient_Video_Visit	Surgery_Vascular	Outpatient
Outpatient_Video_Visit:Temporal_Mandibular_Disorder	Outpatient_Video_Visit	Temporal_Mandibular_Disorder	Outpatient
Outpatient_Video_Visit:Travel_Medicine	Outpatient_Video_Visit	Travel_Medicine	Outpatient
Outpatient_Video_Visit:Urgent_Care	Outpatient_Video_Visit	Urgent_Care	Outpatient
Outpatient_Video_Visit:Urology	Outpatient_Video_Visit	Urology	Outpatient
Outpatient_Video_Visit	Outpatient_Video_Visit		Outpatient
Outpatient_Visit:Addiction_Medicine	Outpatient_Visit	Addiction_Medicine	Outpatient
Outpatient_Visit:Allergy_Asthma_and_Immunology	Outpatient_Visit	Allergy_Asthma_and_Immunology	Outpatient
Outpatient_Visit:Alternative_Medicine	Outpatient_Visit	Alternative_Medicine	Outpatient
Outpatient_Visit:Ambulatory_Surgery	Outpatient_Visit	Ambulatory_Surgery	Outpatient
Outpatient_Visit:Anesthesiology	Outpatient_Visit	Anesthesiology	Outpatient
Outpatient_Visit:Audiology	Outpatient_Visit	Audiology	Outpatient
Outpatient_Visit:Behavioral_Health	Outpatient_Visit	Behavioral_Health	Outpatient
Outpatient_Visit:Bone_Density	Outpatient_Visit	Bone_Density	Outpatient
Outpatient_Visit:Breast_Clinic	Outpatient_Visit	Breast_Clinic	Outpatient
Outpatient_Visit:Cardiology	Outpatient_Visit	Cardiology	Outpatient
Outpatient_Visit:Case_Management	Outpatient_Visit	Case_Management	Outpatient
Outpatient_Visit:Catscan	Outpatient_Visit	Catscan	Outpatient
Outpatient_Visit:Continuing_Care	Outpatient_Visit	Continuing_Care	Outpatient
Outpatient_Visit:Critical_Care_Medicine	Outpatient_Visit	Critical_Care_Medicine	Outpatient
Outpatient_Visit:Dentistry	Outpatient_Visit	Dentistry	Outpatient
Outpatient_Visit:Denturist	Outpatient_Visit	Denturist	Outpatient
Outpatient_Visit:Dermatology	Outpatient_Visit	Dermatology	Outpatient
Outpatient_Visit:Diabetes_Services	Outpatient_Visit	Diabetes_Services	Outpatient
Outpatient_Visit:Durable_Medical_Equipment	Outpatient_Visit	Durable_Medical_Equipment	Outpatient
Outpatient_Visit:EEG	Outpatient_Visit	EEG	Outpatient
Outpatient_Visit:Emergency_Medicine	Outpatient_Visit	Emergency_Medicine	Outpatient
Outpatient_Visit:Emergicenter	Outpatient_Visit	Emergicenter	Outpatient
Outpatient_Visit:Endocrinology_Diabetes/Metabolism	Outpatient_Visit	Endocrinology_Diabetes/Metabolism	Outpatient
Outpatient_Visit:Endoscopy	Outpatient_Visit	Endoscopy	Outpatient
Outpatient_Visit:Expanded_Care	Outpatient_Visit	Expanded_Care	Outpatient
Outpatient_Visit:Eye_Care_Imaging	Outpatient_Visit	Eye_Care_Imaging	Outpatient
Outpatient_Visit:Family_Practice	Outpatient_Visit	Family_Practice	Outpatient
Outpatient_Visit:Foot_Care	Outpatient_Visit	Foot_Care	Outpatient
Outpatient_Visit:Fracture_Clinic	Outpatient_Visit	Fracture_Clinic	Outpatient
Outpatient_Visit:Gastroenterology	Outpatient_Visit	Gastroenterology	Outpatient
Outpatient_Visit:Genetics	Outpatient_Visit	Genetics	Outpatient
Outpatient_Visit:Geriatric_Medicine	Outpatient_Visit	Geriatric_Medicine	Outpatient
Outpatient_Visit:Gynecology_Urology	Outpatient_Visit	Gynecology_Urology	Outpatient
Outpatient_Visit:Health_Education	Outpatient_Visit	Health_Education	Outpatient
Outpatient_Visit:Health_Systems	Outpatient_Visit	Health_Systems	Outpatient
Outpatient_Visit:Home_Health_Care	Outpatient_Visit	Home_Health_Care	Outpatient
Outpatient_Visit:Hospice_Care	Outpatient_Visit	Hospice_Care	Outpatient
Outpatient_Visit:Immunology	Outpatient_Visit	Immunology	Outpatient
Outpatient_Visit:Infectious_Diseases	Outpatient_Visit	Infectious_Diseases	Outpatient
Outpatient_Visit:Infusion_Therapy	Outpatient_Visit	Infusion_Therapy	Outpatient
Outpatient_Visit:Inpatient	Outpatient_Visit	Inpatient	Outpatient
Outpatient_Visit:Internal_Medicine	Outpatient_Visit	Internal_Medicine	Outpatient
Outpatient_Visit:INTERVENTIONAL_RADIOLOGY	Outpatient_Visit	INTERVENTIONAL_RADIOLOGY	Outpatient
Outpatient_Visit:K.P._Recovery_Resources	Outpatient_Visit	K.P._Recovery_Resources	Outpatient
Outpatient_Visit:Labor_&_Delivery	Outpatient_Visit	Labor_&_Delivery	Outpatient
Outpatient_Visit:Laboratory	Outpatient_Visit	Laboratory	Outpatient
Outpatient_Visit:Lifestyle_Medicine	Outpatient_Visit	Lifestyle_Medicine	Outpatient
Outpatient_Visit:Magnet_Resonance_Img	Outpatient_Visit	Magnet_Resonance_Img	Outpatient
Outpatient_Visit:Mammography	Outpatient_Visit	Mammography	Outpatient
Outpatient_Visit:Medical_Ambulatory_Care	Outpatient_Visit	Medical_Ambulatory_Care	Outpatient
Outpatient_Visit:Medical_Records	Outpatient_Visit	Medical_Records	Outpatient
Outpatient_Visit:Mental_Health_IOP	Outpatient_Visit	Mental_Health_IOP	Outpatient
Outpatient_Visit:Minor_Injury_Clinic	Outpatient_Visit	Minor_Injury_Clinic	Outpatient
Outpatient_Visit:Mohs_Surgery_Services	Outpatient_Visit	Mohs_Surgery_Services	Outpatient
Outpatient_Visit:NA	Outpatient_Visit	NA	Outpatient
Outpatient_Visit:Neonatology	Outpatient_Visit	Neonatology	Outpatient
Outpatient_Visit:Nephrology	Outpatient_Visit	Nephrology	Outpatient
Outpatient_Visit:Neurology	Outpatient_Visit	Neurology	Outpatient
Outpatient_Visit:Neurosurgery	Outpatient_Visit	Neurosurgery	Outpatient
Outpatient_Visit:Not_Elsewhere_Classified	Outpatient_Visit	Not_Elsewhere_Classified	Outpatient
Outpatient_Visit:Nuclear_Medicine	Outpatient_Visit	Nuclear_Medicine	Outpatient
Outpatient_Visit:Nurse_Treatment_Room	Outpatient_Visit	Nurse_Treatment_Room	Outpatient
Outpatient_Visit:Nurse_Visit	Outpatient_Visit	Nurse_Visit	Outpatient
Outpatient_Visit:Nutritional_Services	Outpatient_Visit	Nutritional_Services	Outpatient
Outpatient_Visit:Obstetrics_Gynecology	Outpatient_Visit	Obstetrics_Gynecology	Outpatient
Outpatient_Visit:Occupational_Medicine	Outpatient_Visit	Occupational_Medicine	Outpatient
Outpatient_Visit:Occupational_Therapy	Outpatient_Visit	Occupational_Therapy	Outpatient
Outpatient_Visit:Oncology	Outpatient_Visit	Oncology	Outpatient
Outpatient_Visit:Ophthalmology	Outpatient_Visit	Ophthalmology	Outpatient
Outpatient_Visit:Optometry	Outpatient_Visit	Optometry	Outpatient
Outpatient_Visit:Orthopedic_Surgery	Outpatient_Visit	Orthopedic_Surgery	Outpatient
Outpatient_Visit:Otolaryngology	Outpatient_Visit	Otolaryngology	Outpatient
Outpatient_Visit:Pain_Management	Outpatient_Visit	Pain_Management	Outpatient
Outpatient_Visit:Palliative_Care	Outpatient_Visit	Palliative_Care	Outpatient
Outpatient_Visit:Palliative_Care_Home	Outpatient_Visit	Palliative_Care_Home	Outpatient
Outpatient_Visit:Pediatric_Cardiology	Outpatient_Visit	Pediatric_Cardiology	Outpatient
Outpatient_Visit:Pediatric_Endocrinology	Outpatient_Visit	Pediatric_Endocrinology	Outpatient
Outpatient_Visit:Pediatric_Gastroenterology	Outpatient_Visit	Pediatric_Gastroenterology	Outpatient
Outpatient_Visit:Pediatric_Hematology/Oncology	Outpatient_Visit	Pediatric_Hematology/Oncology	Outpatient
Outpatient_Visit:Pediatric_Infectious_Disease	Outpatient_Visit	Pediatric_Infectious_Disease	Outpatient
Outpatient_Visit:Pediatric_Nephrology	Outpatient_Visit	Pediatric_Nephrology	Outpatient
Outpatient_Visit:Pediatric_Neurology	Outpatient_Visit	Pediatric_Neurology	Outpatient
Outpatient_Visit:Pediatric_Pulmonology	Outpatient_Visit	Pediatric_Pulmonology	Outpatient
Outpatient_Visit:Pediatrics	Outpatient_Visit	Pediatrics	Outpatient
Outpatient_Visit:Perinatology	Outpatient_Visit	Perinatology	Outpatient
Outpatient_Visit:Peritoneal_Dialysis	Outpatient_Visit	Peritoneal_Dialysis	Outpatient
Outpatient_Visit:Pet_Scan	Outpatient_Visit	Pet_Scan	Outpatient
Outpatient_Visit:Pharmacy	Outpatient_Visit	Pharmacy	Outpatient
Outpatient_Visit:Physical_Medicine	Outpatient_Visit	Physical_Medicine	Outpatient
Outpatient_Visit:Physical_Therapy	Outpatient_Visit	Physical_Therapy	Outpatient
Outpatient_Visit:Plastic_Surgery	Outpatient_Visit	Plastic_Surgery	Outpatient
Outpatient_Visit:Podiatry	Outpatient_Visit	Podiatry	Outpatient
Outpatient_Visit:Population_Care_Management	Outpatient_Visit	Population_Care_Management	Outpatient
Outpatient_Visit:Pre-operative_Medicine	Outpatient_Visit	Pre-operative_Medicine	Outpatient
Outpatient_Visit:Primary_Care	Outpatient_Visit	Primary_Care	Outpatient
Outpatient_Visit:Procedure_Room	Outpatient_Visit	Procedure_Room	Outpatient
Outpatient_Visit:Psychiatry	Outpatient_Visit	Psychiatry	Outpatient
Outpatient_Visit:Psychiatry_Geriatric	Outpatient_Visit	Psychiatry_Geriatric	Outpatient
Outpatient_Visit:Pulmonary_Diseases	Outpatient_Visit	Pulmonary_Diseases	Outpatient
Outpatient_Visit:Pulmonary_Funct_Lab	Outpatient_Visit	Pulmonary_Funct_Lab	Outpatient
Outpatient_Visit:Radiation_Oncology	Outpatient_Visit	Radiation_Oncology	Outpatient
Outpatient_Visit:Radiology	Outpatient_Visit	Radiology	Outpatient
Outpatient_Visit:Research_Medicine	Outpatient_Visit	Research_Medicine	Outpatient
Outpatient_Visit:Respiratory_Case_Management	Outpatient_Visit	Respiratory_Case_Management	Outpatient
Outpatient_Visit:Respiratory_Therapy	Outpatient_Visit	Respiratory_Therapy	Outpatient
Outpatient_Visit:Rheumatology	Outpatient_Visit	Rheumatology	Outpatient
Outpatient_Visit:Sleep_Clinic	Outpatient_Visit	Sleep_Clinic	Outpatient
Outpatient_Visit:Sleep_Medicine	Outpatient_Visit	Sleep_Medicine	Outpatient
Outpatient_Visit:Social_Services	Outpatient_Visit	Social_Services	Outpatient
Outpatient_Visit:Speech_Therapy	Outpatient_Visit	Speech_Therapy	Outpatient
Outpatient_Visit:Sports_Medicine	Outpatient_Visit	Sports_Medicine	Outpatient
Outpatient_Visit:Surgery_Ambulatory	Outpatient_Visit	Surgery_Ambulatory	Outpatient
Outpatient_Visit:Surgery_Cardiovascular	Outpatient_Visit	Surgery_Cardiovascular	Outpatient
Outpatient_Visit:Surgery_General	Outpatient_Visit	Surgery_General	Outpatient
Outpatient_Visit:Surgery_Maxillofacial	Outpatient_Visit	Surgery_Maxillofacial	Outpatient
Outpatient_Visit:Surgery_Vascular	Outpatient_Visit	Surgery_Vascular	Outpatient
Outpatient_Visit:Temporal_Mandibular_Disorder	Outpatient_Visit	Temporal_Mandibular_Disorder	Outpatient
Outpatient_Visit:TRANSCRIPTION	Outpatient_Visit	TRANSCRIPTION	Outpatient
Outpatient_Visit:Travel_Medicine	Outpatient_Visit	Travel_Medicine	Outpatient
Outpatient_Visit:Tumor_Registry	Outpatient_Visit	Tumor_Registry	Outpatient
Outpatient_Visit:Ultrasound	Outpatient_Visit	Ultrasound	Outpatient
Outpatient_Visit:Urgent_Care	Outpatient_Visit	Urgent_Care	Outpatient
Outpatient_Visit:Urology	Outpatient_Visit	Urology	Outpatient
Outpatient_Visit:Weight_Management	Outpatient_Visit	Weight_Management	Outpatient
Outpatient_Visit:Wound_Care	Outpatient_Visit	Wound_Care	Outpatient
Outpatient_Visit	Outpatient_Visit		Outpatient
Residential:Addiction_Medicine	Residential	Addiction_Medicine	Mental_Health
Residential:NA	Residential	NA	Mental_Health
Residential:Psychiatry	Residential	Psychiatry	Mental_Health
Residential	Residential		Mental_Health
Respite:NA	Respite	NA	Other
Respite	Respite		Other
Short_Term_Rehab:NA	Short_Term_Rehab	NA	Other
Short_Term_Rehab	Short_Term_Rehab		Other
Skilled_Nursing_Facility:NA	Skilled_Nursing_Facility	NA	SNF
Skilled_Nursing_Facility	Skilled_Nursing_Facility		SNF
